fips,year,laborfc,employed,unemplvl,unemprate
1001,2015,25652,24321,1331,5.2
1003,2015,87872,83010,4862,5.5
1005,2015,8625,7860,765,8.9
1007,2015,8589,8021,568,6.6
1009,2015,24521,23198,1323,5.4
1011,2015,4785,4406,379,7.9
1013,2015,9151,8457,694,7.6
1015,2015,45995,42764,3231,7
1017,2015,15002,14097,905,6
1019,2015,11179,10570,609,5.4
1021,2015,19171,18090,1081,5.6
1023,2015,4386,3988,398,9.1
1025,2015,8006,7068,938,11.7
1027,2015,5559,5219,340,6.1
1029,2015,5688,5346,342,6
1031,2015,20309,19100,1209,6
1033,2015,23647,21776,1871,7.9
1035,2015,4690,4258,432,9.199999999999999
1037,2015,4434,4138,296,6.7
1039,2015,15487,14382,1105,7.1
1041,2015,6367,5986,381,6
1043,2015,36456,34541,1915,5.3
1045,2015,19875,18612,1263,6.4
1047,2015,15617,14122,1495,9.6
1049,2015,28822,27076,1746,6.1
1051,2015,36814,34967,1847,5
1053,2015,14624,13598,1026,7
1055,2015,42767,40126,2641,6.2
1057,2015,6434,5983,451,7
1059,2015,13687,12807,880,6.4
1061,2015,10807,10168,639,5.9
1063,2015,2883,2564,319,11.1
1065,2015,6058,5588,470,7.8
1067,2015,6729,6272,457,6.8
1069,2015,44627,41850,2777,6.2
1071,2015,23506,21944,1562,6.6
1073,2015,311481,293544,17937,5.8
1075,2015,5626,5271,355,6.3
1077,2015,42725,39766,2959,6.9
1079,2015,13698,12641,1057,7.7
1081,2015,70996,67274,3722,5.2
1083,2015,40022,37833,2189,5.5
1085,2015,3834,3392,442,11.5
1087,2015,7983,7341,642,8
1089,2015,171217,161839,9378,5.5
1091,2015,7419,6853,566,7.6
1093,2015,12506,11638,868,6.9
1095,2015,40466,38126,2340,5.8
1097,2015,187264,174405,12859,6.9
1099,2015,7353,6614,739,10.1
1101,2015,105246,98841,6405,6.1
1103,2015,55016,51781,3235,5.9
1105,2015,3491,3143,348,10
1107,2015,8022,7480,542,6.8
1109,2015,14967,13984,983,6.6
1111,2015,9451,8894,557,5.9
1113,2015,24152,22720,1432,5.9
1115,2015,38638,36625,2013,5.2
1117,2015,108408,103851,4557,4.2
1119,2015,5117,4709,408,8
1121,2015,35198,32890,2308,6.6
1123,2015,18776,17633,1143,6.1
1125,2015,99051,93669,5382,5.4
1127,2015,25610,23762,1848,7.2
1129,2015,6711,6114,597,8.9
1131,2015,2829,2415,414,14.6
1133,2015,9393,8686,707,7.5
2013,2015,2475,2396,79,3.2
2016,2015,4065,3908,157,3.9
2020,2015,156755,148856,7899,5
2050,2015,7363,6304,1059,14.4
2060,2015,382,346,36,9.4
2068,2015,1071,977,94,8.800000000000001
2070,2015,2040,1843,197,9.699999999999999
2090,2015,46396,43863,2533,5.5
2100,2015,1087,980,107,9.800000000000001
2105,2015,1134,962,172,15.2
2110,2015,17090,16284,806,4.7
2122,2015,27633,25472,2161,7.8
2130,2015,6964,6484,480,6.9
2150,2015,6620,6301,319,4.8
2158,2015,2809,2160,649,23.1
2164,2015,646,565,81,12.5
2170,2015,46183,42634,3549,7.7
2180,2015,4083,3596,487,11.9
2185,2015,4305,4059,246,5.7
2188,2015,2910,2444,466,16
2195,2015,1494,1361,133,8.9
2198,2015,2763,2415,348,12.6
2220,2015,4601,4389,212,4.6
2230,2015,812,718,94,11.6
2240,2015,3009,2688,321,10.7
2261,2015,4881,4458,423,8.699999999999999
2275,2015,1031,950,81,7.9
2282,2015,259,237,22,8.5
2290,2015,2411,1968,443,18.4
4001,2015,20589,17854,2735,13.3
4003,2015,50257,46600,3657,7.3
4005,2015,73189,68434,4755,6.5
4007,2015,21181,19512,1669,7.9
4009,2015,14496,13432,1064,7.3
4011,2015,4042,3722,320,7.9
4012,2015,8163,7555,608,7.4
4013,2015,2020413,1916900,103513,5.1
4015,2015,79480,73176,6304,7.9
4017,2015,40659,36734,3925,9.699999999999999
4019,2015,464811,439360,25451,5.5
4021,2015,157022,147161,9861,6.3
4023,2015,19852,17578,2274,11.5
4025,2015,96111,90721,5390,5.6
4027,2015,93568,73279,20289,21.7
5001,2015,9477,9082,395,4.2
5003,2015,8350,7720,630,7.5
5005,2015,16192,15306,886,5.5
5007,2015,121607,117035,4572,3.8
5009,2015,15814,15046,768,4.9
5011,2015,4551,4286,265,5.8
5013,2015,2415,2285,130,5.4
5015,2015,12635,12059,576,4.6
5017,2015,3722,3385,337,9.1
5019,2015,9606,9084,522,5.4
5021,2015,6286,5872,414,6.6
5023,2015,9601,8937,664,6.9
5025,2015,3352,3163,189,5.6
5027,2015,9543,8922,621,6.5
5029,2015,8631,8107,524,6.1
5031,2015,50907,48657,2250,4.4
5033,2015,26802,25414,1388,5.2
5035,2015,21379,20066,1313,6.1
5037,2015,8088,7651,437,5.4
5039,2015,2969,2763,206,6.9
5041,2015,5547,5144,403,7.3
5043,2015,8069,7518,551,6.8
5045,2015,59799,57020,2779,4.6
5047,2015,7399,7034,365,4.9
5049,2015,4751,4504,247,5.2
5051,2015,39876,37701,2175,5.5
5053,2015,8243,7869,374,4.5
5055,2015,19917,18887,1030,5.2
5057,2015,9907,9421,486,4.9
5059,2015,14175,13463,712,5
5061,2015,6072,5817,255,4.2
5063,2015,15644,14635,1009,6.4
5065,2015,4971,4643,328,6.6
5067,2015,6177,5713,464,7.5
5069,2015,28718,26696,2022,7
5071,2015,10385,9790,595,5.7
5073,2015,2644,2445,199,7.5
5075,2015,7034,6612,422,6
5077,2015,3175,2964,211,6.6
5079,2015,4119,3866,253,6.1
5081,2015,5584,5280,304,5.4
5083,2015,9150,8625,525,5.7
5085,2015,32939,31561,1378,4.2
5087,2015,7070,6798,272,3.8
5089,2015,6513,6176,337,5.2
5091,2015,19874,18882,992,5
5093,2015,18310,16663,1647,9
5095,2015,2969,2790,179,6
5097,2015,3253,3034,219,6.7
5099,2015,3653,3472,181,5
5101,2015,3388,3224,164,4.8
5103,2015,9921,9296,625,6.3
5105,2015,4194,3937,257,6.1
5107,2015,6983,6455,528,7.6
5109,2015,4207,3961,246,5.8
5111,2015,10046,9485,561,5.6
5113,2015,8313,7834,479,5.8
5115,2015,29710,28147,1563,5.3
5117,2015,3722,3548,174,4.7
5119,2015,185721,177247,8474,4.6
5121,2015,6175,5734,441,7.1
5123,2015,8940,8296,644,7.2
5125,2015,55892,53618,2274,4.1
5127,2015,4519,4304,215,4.8
5129,2015,3021,2851,170,5.6
5131,2015,57625,54862,2763,4.8
5133,2015,5655,5313,342,6
5135,2015,5994,5581,413,6.9
5137,2015,4696,4403,293,6.2
5139,2015,16901,15869,1032,6.1
5141,2015,6416,5986,430,6.7
5143,2015,115028,110974,4054,3.5
5145,2015,34483,32344,2139,6.2
5147,2015,3025,2832,193,6.4
5149,2015,8948,8495,453,5.1
6001,2015,818947,780110,38837,4.7
6003,2015,548,508,40,7.3
6005,2015,14315,13370,945,6.6
6007,2015,101046,93792,7254,7.2
6009,2015,20546,19236,1310,6.4
6011,2015,11042,9344,1698,15.4
6013,2015,544572,517190,27382,5
6015,2015,9852,9011,841,8.5
6017,2015,87880,82863,5017,5.7
6019,2015,440126,395282,44844,10.2
6021,2015,12959,11830,1129,8.699999999999999
6023,2015,62280,58798,3482,5.6
6025,2015,76651,57880,18771,24.5
6027,2015,9080,8554,526,5.8
6029,2015,389978,350147,39831,10.2
6031,2015,57703,51642,6061,10.5
6033,2015,29000,26798,2202,7.6
6035,2015,10758,9981,777,7.2
6037,2015,4980324,4650739,329585,6.6
6039,2015,59781,53495,6286,10.5
6041,2015,138683,133755,4928,3.6
6043,2015,8009,7438,571,7.1
6045,2015,39826,37510,2316,5.8
6047,2015,114003,101058,12945,11.4
6049,2015,3302,3020,282,8.5
6051,2015,8238,7734,504,6.1
6053,2015,218201,200504,17697,8.1
6055,2015,73715,70309,3406,4.6
6057,2015,48002,45400,2602,5.4
6059,2015,1584258,1513475,70783,4.5
6061,2015,176321,167413,8908,5.1
6063,2015,7888,7078,810,10.3
6065,2015,1033286,964088,69198,6.7
6067,2015,684493,643471,41022,6
6069,2015,29752,27503,2249,7.6
6071,2015,919166,859967,59199,6.4
6073,2015,1548611,1468089,80522,5.2
6075,2015,541430,521710,19720,3.6
6077,2015,314300,286358,27942,8.9
6079,2015,138909,132340,6569,4.7
6081,2015,434254,419424,14830,3.4
6083,2015,217139,205647,11492,5.3
6085,2015,1012212,970215,41997,4.1
6087,2015,143192,132470,10722,7.5
6089,2015,74104,68344,5760,7.8
6091,2015,1361,1242,119,8.699999999999999
6093,2015,17877,16203,1674,9.4
6095,2015,204832,192289,12543,6.1
6097,2015,257647,246095,11552,4.5
6099,2015,240897,218031,22866,9.5
6101,2015,44714,39936,4778,10.7
6103,2015,25014,23036,1978,7.9
6105,2015,5139,4740,399,7.8
6107,2015,202026,178541,23485,11.6
6109,2015,21528,20011,1517,7
6111,2015,427196,403089,24107,5.6
6113,2015,104138,97411,6727,6.5
6115,2015,27716,25142,2574,9.300000000000001
8001,2015,247734,236920,10814,4.4
8003,2015,7651,7254,397,5.2
8005,2015,334282,321765,12517,3.7
8007,2015,6010,5766,244,4.1
8009,2015,1969,1929,40,2
8011,2015,1732,1663,69,4
8013,2015,176721,171087,5634,3.2
8014,2015,35530,34350,1180,3.3
8015,2015,8491,8200,291,3.4
8017,2015,1010,983,27,2.7
8019,2015,5543,5339,204,3.7
8021,2015,3598,3392,206,5.7
8023,2015,1622,1518,104,6.4
8025,2015,1352,1292,60,4.4
8027,2015,1987,1917,70,3.5
8029,2015,13441,12669,772,5.7
8031,2015,375501,361560,13941,3.7
8033,2015,1323,1281,42,3.2
8035,2015,172105,166747,5358,3.1
8037,2015,32737,31705,1032,3.2
8039,2015,13257,12838,419,3.2
8041,2015,307619,293427,14192,4.6
8043,2015,14500,13601,899,6.2
8045,2015,30462,29192,1270,4.2
8047,2015,3397,3291,106,3.1
8049,2015,9052,8759,293,3.2
8051,2015,9788,9498,290,3
8053,2015,440,426,14,3.2
8055,2015,2370,2186,184,7.8
8057,2015,834,803,31,3.7
8059,2015,308779,297832,10947,3.5
8061,2015,790,769,21,2.7
8063,2015,4318,4214,104,2.4
8065,2015,4567,4389,178,3.9
8067,2015,29850,28816,1034,3.5
8069,2015,180535,174533,6002,3.3
8071,2015,6127,5782,345,5.6
8073,2015,2168,2094,74,3.4
8075,2015,10929,10594,335,3.1
8077,2015,71795,67800,3995,5.6
8079,2015,445,429,16,3.6
8081,2015,7104,6780,324,4.6
8083,2015,12337,11633,704,5.7
8085,2015,19324,18344,980,5.1
8087,2015,14665,14105,560,3.8
8089,2015,7882,7423,459,5.8
8091,2015,2153,2060,93,4.3
8093,2015,9366,9042,324,3.5
8095,2015,2356,2300,56,2.4
8097,2015,10735,10318,417,3.9
8099,2015,5811,5575,236,4.1
8101,2015,71695,67626,4069,5.7
8103,2015,2807,2658,149,5.3
8105,2015,4865,4557,308,6.3
8107,2015,14275,13809,466,3.3
8109,2015,3078,2888,190,6.2
8111,2015,470,450,20,4.3
8113,2015,5072,4879,193,3.8
8115,2015,1146,1107,39,3.4
8117,2015,20554,20032,522,2.5
8119,2015,11402,10891,511,4.5
8121,2015,2784,2712,72,2.6
8123,2015,147740,142027,5713,3.9
8125,2015,5130,4995,135,2.6
9001,2015,478829,453172,25657,5.4
9003,2015,474171,446356,27815,5.9
9005,2015,105193,99752,5441,5.2
9007,2015,92122,87571,4551,4.9
9009,2015,454890,426557,28333,6.2
9011,2015,136120,128030,8090,5.9
9013,2015,85088,80865,4223,5
9015,2015,62583,58612,3971,6.3
10001,2015,76253,72145,4108,5.4
10003,2015,291188,277487,13701,4.7
10005,2015,98047,93224,4823,4.9
11001,2015,389101,362304,26797,6.9
12001,2015,129266,123302,5964,4.6
12003,2015,11152,10530,622,5.6
12005,2015,87379,82599,4780,5.5
12007,2015,10725,10207,518,4.8
12009,2015,255977,240638,15339,6
12011,2015,986384,935820,50564,5.1
12013,2015,4932,4630,302,6.1
12015,2015,67537,63481,4056,6
12017,2015,47723,44135,3588,7.5
12019,2015,98277,93321,4956,5
12021,2015,163394,154808,8586,5.3
12023,2015,28924,27332,1592,5.5
12027,2015,13354,12578,776,5.8
12029,2015,5576,5229,347,6.2
12031,2015,459730,433044,26686,5.8
12033,2015,137865,130169,7696,5.6
12035,2015,43593,40852,2741,6.3
12037,2015,4764,4540,224,4.7
12039,2015,18178,16870,1308,7.2
12041,2015,6487,6119,368,5.7
12043,2015,4702,4366,336,7.1
12045,2015,5984,5669,315,5.3
12047,2015,4514,4221,293,6.5
12049,2015,10072,9368,704,7
12051,2015,15069,13466,1603,10.6
12053,2015,65979,61388,4591,7
12055,2015,35276,32631,2645,7.5
12057,2015,688082,653305,34777,5.1
12059,2015,6680,6269,411,6.2
12061,2015,61105,56918,4187,6.9
12063,2015,17280,16261,1019,5.9
12065,2015,5365,5045,320,6
12067,2015,3199,3052,147,4.6
12069,2015,140535,132786,7749,5.5
12071,2015,318777,302326,16451,5.2
12073,2015,147291,139884,7407,5
12075,2015,16416,15467,949,5.8
12077,2015,2634,2479,155,5.9
12079,2015,7461,7003,458,6.1
12081,2015,164586,156243,8343,5.1
12083,2015,129944,121503,8441,6.5
12085,2015,69371,65647,3724,5.4
12086,2015,1297545,1220715,76830,5.9
12087,2015,45697,44105,1592,3.5
12089,2015,36493,34618,1875,5.1
12091,2015,91566,87418,4148,4.5
12093,2015,17217,16132,1085,6.3
12095,2015,684810,650412,34398,5
12097,2015,156990,147922,9068,5.8
12099,2015,689637,654384,35253,5.1
12101,2015,214981,202354,12627,5.9
12103,2015,469790,446528,23262,5
12105,2015,279437,261765,17672,6.3
12107,2015,27214,25136,2078,7.6
12109,2015,113170,108708,4462,3.9
12111,2015,131063,122711,8352,6.4
12113,2015,73829,70258,3571,4.8
12115,2015,177492,168491,9001,5.1
12117,2015,236207,224575,11632,4.9
12119,2015,28580,26381,2199,7.7
12121,2015,17903,16926,977,5.5
12123,2015,8963,8361,602,6.7
12125,2015,4727,4497,230,4.9
12127,2015,238220,224287,13933,5.8
12129,2015,13934,13284,650,4.7
12131,2015,27791,26485,1306,4.7
12133,2015,9592,9021,571,6
13001,2015,8638,8004,634,7.3
13003,2015,3849,3627,222,5.8
13005,2015,4875,4594,281,5.8
13007,2015,1120,1038,82,7.3
13009,2015,17678,16318,1360,7.7
13011,2015,8187,7729,458,5.6
13013,2015,35970,34070,1900,5.3
13015,2015,46662,43905,2757,5.9
13017,2015,5456,4962,494,9.1
13019,2015,7018,6511,507,7.2
13021,2015,67649,63128,4521,6.7
13023,2015,4354,3981,373,8.6
13025,2015,6877,6362,515,7.5
13027,2015,6857,6438,419,6.1
13029,2015,16080,15232,848,5.3
13031,2015,34596,32490,2106,6.1
13033,2015,9095,8353,742,8.199999999999999
13035,2015,10084,9411,673,6.7
13037,2015,2120,1988,132,6.2
13039,2015,22210,20973,1237,5.6
13043,2015,4946,4664,282,5.7
13045,2015,51578,48097,3481,6.7
13047,2015,31243,29604,1639,5.2
13049,2015,4748,4443,305,6.4
13051,2015,132710,124919,7791,5.9
13053,2015,2101,1916,185,8.800000000000001
13055,2015,10508,9857,651,6.2
13057,2015,119849,114221,5628,4.7
13059,2015,56900,53422,3478,6.1
13061,2015,856,755,101,11.8
13063,2015,125877,116241,9636,7.7
13065,2015,2762,2567,195,7.1
13067,2015,396618,376441,20177,5.1
13069,2015,17220,16057,1163,6.8
13071,2015,19969,18688,1281,6.4
13073,2015,68356,64916,3440,5
13075,2015,7257,6770,487,6.7
13077,2015,67571,63968,3603,5.3
13079,2015,5553,5202,351,6.3
13081,2015,9387,8742,645,6.9
13083,2015,7819,7389,430,5.5
13085,2015,10899,10340,559,5.1
13087,2015,11346,10572,774,6.8
13089,2015,371561,349045,22516,6.1
13091,2015,6929,6346,583,8.4
13093,2015,4739,4380,359,7.6
13095,2015,37725,34801,2924,7.8
13097,2015,68056,63726,4330,6.4
13099,2015,4340,4038,302,7
13101,2015,1858,1771,87,4.7
13103,2015,27055,25667,1388,5.1
13105,2015,7583,7017,566,7.5
13107,2015,8284,7556,728,8.800000000000001
13109,2015,4645,4384,261,5.6
13111,2015,10072,9446,626,6.2
13113,2015,53937,51128,2809,5.2
13115,2015,42805,39935,2870,6.7
13117,2015,103977,99241,4736,4.6
13119,2015,9248,8665,583,6.3
13121,2015,512558,481798,30760,6
13123,2015,11674,10966,708,6.1
13125,2015,1228,1146,82,6.7
13127,2015,37537,35248,2289,6.1
13129,2015,26044,24500,1544,5.9
13131,2015,10379,9752,627,6
13133,2015,6800,6347,453,6.7
13135,2015,450568,427100,23468,5.2
13137,2015,18739,17663,1076,5.7
13139,2015,92394,87887,4507,4.9
13141,2015,2478,2234,244,9.800000000000001
13143,2015,11820,11044,776,6.6
13145,2015,15635,14812,823,5.3
13147,2015,10359,9714,645,6.2
13149,2015,4891,4576,315,6.4
13151,2015,104603,98130,6473,6.2
13153,2015,65413,61586,3827,5.9
13155,2015,3121,2859,262,8.4
13157,2015,30617,29129,1488,4.9
13159,2015,6414,6059,355,5.5
13161,2015,6318,5895,423,6.7
13163,2015,6341,5766,575,9.1
13165,2015,3093,2834,259,8.4
13167,2015,3856,3585,271,7
13169,2015,13421,12677,744,5.5
13171,2015,7651,7060,591,7.7
13173,2015,3766,3514,252,6.7
13175,2015,18566,17158,1408,7.6
13177,2015,14070,13319,751,5.3
13179,2015,24869,23291,1578,6.3
13181,2015,3351,3124,227,6.8
13183,2015,7056,6640,416,5.9
13185,2015,50156,47179,2977,5.9
13187,2015,15257,14429,828,5.4
13189,2015,8750,8019,731,8.4
13191,2015,5795,5417,378,6.5
13193,2015,4598,4174,424,9.199999999999999
13195,2015,12574,11873,701,5.6
13197,2015,3432,3141,291,8.5
13199,2015,8636,7941,695,8
13201,2015,2660,2515,145,5.5
13205,2015,8682,8095,587,6.8
13207,2015,12618,11881,737,5.8
13209,2015,3696,3374,322,8.699999999999999
13211,2015,8388,7925,463,5.5
13213,2015,16004,14820,1184,7.4
13215,2015,78576,72687,5889,7.5
13217,2015,48236,44962,3274,6.8
13219,2015,17517,16738,779,4.4
13221,2015,6699,6326,373,5.6
13223,2015,76015,72045,3970,5.2
13225,2015,11242,10347,895,8
13227,2015,13817,13079,738,5.3
13229,2015,8012,7510,502,6.3
13231,2015,8194,7723,471,5.7
13233,2015,18074,16872,1202,6.7
13235,2015,3996,3732,264,6.6
13237,2015,7770,7140,630,8.1
13239,2015,813,757,56,6.9
13241,2015,6476,6040,436,6.7
13243,2015,2416,2195,221,9.1
13245,2015,83946,77701,6245,7.4
13247,2015,42097,39339,2758,6.6
13249,2015,2101,1961,140,6.7
13251,2015,5020,4601,419,8.300000000000001
13253,2015,3077,2827,250,8.1
13255,2015,27004,24822,2182,8.1
13257,2015,10818,10108,710,6.6
13259,2015,2106,1960,146,6.9
13261,2015,12781,11713,1068,8.4
13263,2015,2685,2477,208,7.7
13265,2015,590,544,46,7.8
13267,2015,9238,8666,572,6.2
13269,2015,2762,2507,255,9.199999999999999
13271,2015,4805,4385,420,8.699999999999999
13273,2015,3617,3346,271,7.5
13275,2015,16746,15530,1216,7.3
13277,2015,18271,17150,1121,6.1
13279,2015,11816,10780,1036,8.800000000000001
13281,2015,3900,3591,309,7.9
13283,2015,2689,2460,229,8.5
13285,2015,35450,33286,2164,6.1
13287,2015,3179,2963,216,6.8
13289,2015,2953,2683,270,9.1
13291,2015,9790,9265,525,5.4
13293,2015,11085,10278,807,7.3
13295,2015,29277,27521,1756,6
13297,2015,41501,39247,2254,5.4
13299,2015,14428,13485,943,6.5
13301,2015,2629,2423,206,7.8
13303,2015,7168,6665,503,7
13305,2015,11521,10683,838,7.3
13307,2015,965,874,91,9.4
13309,2015,1687,1503,184,10.9
13311,2015,13726,13012,714,5.2
13313,2015,45411,42498,2913,6.4
13315,2015,2732,2517,215,7.9
13317,2015,3874,3593,281,7.3
13319,2015,3589,3325,264,7.4
13321,2015,8808,8235,573,6.5
15001,2015,89882,85982,3900,4.3
15003,2015,462771,447183,15588,3.4
15007,2015,36014,34602,1412,3.9
15009,2015,85146,82040,3106,3.6
16001,2015,217294,209558,7736,3.6
16003,2015,1715,1587,128,7.5
16005,2015,41904,40263,1641,3.9
16007,2015,2830,2706,124,4.4
16009,2015,4036,3776,260,6.4
16011,2015,22061,21177,884,4
16013,2015,11830,11418,412,3.5
16015,2015,3051,2862,189,6.2
16017,2015,18529,17446,1083,5.8
16019,2015,51022,49281,1741,3.4
16021,2015,5091,4816,275,5.4
16023,2015,1277,1220,57,4.5
16025,2015,648,626,22,3.4
16027,2015,90998,86548,4450,4.9
16029,2015,3766,3614,152,4
16031,2015,11466,11090,376,3.3
16033,2015,395,381,14,3.5
16035,2015,3084,2841,243,7.9
16037,2015,2130,1991,139,6.5
16039,2015,10742,10246,496,4.6
16041,2015,6456,6258,198,3.1
16043,2015,7180,6924,256,3.6
16045,2015,7534,7145,389,5.2
16047,2015,7982,7710,272,3.4
16049,2015,6397,6007,390,6.1
16051,2015,12474,12056,418,3.4
16053,2015,11336,10969,367,3.2
16055,2015,71608,68042,3566,5
16057,2015,19483,18824,659,3.4
16059,2015,3377,3145,232,6.9
16061,2015,1592,1502,90,5.7
16063,2015,2641,2524,117,4.4
16065,2015,19783,19263,520,2.6
16067,2015,10689,10305,384,3.6
16069,2015,20628,19878,750,3.6
16071,2015,2127,2053,74,3.5
16073,2015,5215,4970,245,4.7
16075,2015,11101,10561,540,4.9
16077,2015,3877,3700,177,4.6
16079,2015,5124,4733,391,7.6
16081,2015,5826,5629,197,3.4
16083,2015,39033,37618,1415,3.6
16085,2015,4792,4502,290,6.1
16087,2015,4566,4305,261,5.7
17001,2015,32540,30931,1609,4.9
17003,2015,2293,2084,209,9.1
17005,2015,7785,7375,410,5.3
17007,2015,26308,24600,1708,6.5
17009,2015,2779,2681,98,3.5
17011,2015,17118,16024,1094,6.4
17013,2015,2342,2185,157,6.7
17015,2015,7940,7509,431,5.4
17017,2015,6430,6068,362,5.6
17019,2015,107281,101892,5389,5
17021,2015,15407,14394,1013,6.6
17023,2015,8085,7585,500,6.2
17025,2015,6621,6155,466,7
17027,2015,20090,19190,900,4.5
17029,2015,24099,22648,1451,6
17031,2015,2646181,2481097,165084,6.2
17033,2015,9636,9069,567,5.9
17035,2015,5910,5600,310,5.2
17037,2015,54770,51734,3036,5.5
17039,2015,7969,7529,440,5.5
17041,2015,10158,9665,493,4.9
17043,2015,511538,487123,24415,4.8
17045,2015,9435,8849,586,6.2
17047,2015,2946,2771,175,5.9
17049,2015,18425,17547,878,4.8
17051,2015,9704,9071,633,6.5
17053,2015,6654,6304,350,5.3
17055,2015,16494,15168,1326,8
17057,2015,15792,14595,1197,7.6
17059,2015,2467,2303,164,6.6
17061,2015,6050,5681,369,6.1
17063,2015,25461,23689,1772,7
17065,2015,4379,4140,239,5.5
17067,2015,8917,8369,548,6.1
17069,2015,1529,1400,129,8.4
17071,2015,3751,3527,224,6
17073,2015,25203,23669,1534,6.1
17075,2015,14758,13925,833,5.6
17077,2015,28644,27060,1584,5.5
17079,2015,4642,4354,288,6.2
17081,2015,17180,16027,1153,6.7
17083,2015,11082,10384,698,6.3
17085,2015,11456,10833,623,5.4
17087,2015,4135,3784,351,8.5
17089,2015,268299,252962,15337,5.7
17091,2015,54269,50568,3701,6.8
17093,2015,66208,62761,3447,5.2
17095,2015,23216,21810,1406,6.1
17097,2015,366809,347139,19670,5.4
17099,2015,57429,53449,3980,6.9
17101,2015,6146,5712,434,7.1
17103,2015,17855,16907,948,5.3
17105,2015,17266,16342,924,5.4
17107,2015,12991,12291,700,5.4
17109,2015,14077,13225,852,6.1
17111,2015,165762,156757,9005,5.4
17113,2015,91296,86960,4336,4.7
17115,2015,50862,47341,3521,6.9
17117,2015,23062,21612,1450,6.3
17119,2015,133073,125128,7945,6
17121,2015,18100,16884,1216,6.7
17123,2015,5708,5332,376,6.6
17125,2015,6611,6142,469,7.1
17127,2015,6081,5640,441,7.3
17129,2015,6616,6301,315,4.8
17131,2015,8233,7722,511,6.2
17133,2015,18106,17318,788,4.4
17135,2015,12020,11114,906,7.5
17137,2015,16938,16093,845,5
17139,2015,7377,7058,319,4.3
17141,2015,25913,24325,1588,6.1
17143,2015,89959,83822,6137,6.8
17145,2015,8860,8232,628,7.1
17147,2015,8546,8128,418,4.9
17149,2015,7618,7226,392,5.1
17151,2015,1766,1643,123,7
17153,2015,2090,1906,184,8.800000000000001
17155,2015,3042,2856,186,6.1
17157,2015,14311,13539,772,5.4
17159,2015,7467,7032,435,5.8
17161,2015,72613,68011,4602,6.3
17163,2015,126230,117968,8262,6.5
17165,2015,10352,9555,797,7.7
17167,2015,103431,97990,5441,5.3
17169,2015,3483,3281,202,5.8
17171,2015,2553,2403,150,5.9
17173,2015,10247,9648,599,5.8
17175,2015,2763,2580,183,6.6
17177,2015,21547,20132,1415,6.6
17179,2015,66829,62661,4168,6.2
17181,2015,7357,6795,562,7.6
17183,2015,35349,32854,2495,7.1
17185,2015,5625,5309,316,5.6
17187,2015,8569,8125,444,5.2
17189,2015,9360,9008,352,3.8
17191,2015,7504,6990,514,6.8
17193,2015,6932,6537,395,5.7
17195,2015,28529,26774,1755,6.2
17197,2015,356715,334626,22089,6.2
17199,2015,31940,29977,1963,6.1
17201,2015,142004,132098,9906,7
17203,2015,19570,18583,987,5
18001,2015,16898,16252,646,3.8
18003,2015,178014,169803,8211,4.6
18005,2015,43578,41999,1579,3.6
18007,2015,4577,4372,205,4.5
18009,2015,5243,4926,317,6
18011,2015,33491,32253,1238,3.7
18013,2015,7443,7086,357,4.8
18015,2015,10021,9586,435,4.3
18017,2015,17759,16941,818,4.6
18019,2015,58780,56127,2653,4.5
18021,2015,12367,11711,656,5.3
18023,2015,16918,16236,682,4
18025,2015,4915,4617,298,6.1
18027,2015,15694,15099,595,3.8
18029,2015,25213,23917,1296,5.1
18031,2015,14291,13709,582,4.1
18033,2015,21782,20884,898,4.1
18035,2015,54440,51332,3108,5.7
18037,2015,22673,21903,770,3.4
18039,2015,104707,100631,4076,3.9
18041,2015,8989,8398,591,6.6
18043,2015,39858,38143,1715,4.3
18045,2015,8042,7563,479,6
18047,2015,11387,10808,579,5.1
18049,2015,9861,9388,473,4.8
18051,2015,18859,18141,718,3.8
18053,2015,32523,30756,1767,5.4
18055,2015,13754,12807,947,6.9
18057,2015,167222,161556,5666,3.4
18059,2015,37368,35787,1581,4.2
18061,2015,19380,18489,891,4.6
18063,2015,82855,79677,3178,3.8
18065,2015,21664,20509,1155,5.3
18067,2015,36986,35136,1850,5
18069,2015,18639,17822,817,4.4
18071,2015,21784,20915,869,4
18073,2015,16360,15406,954,5.8
18075,2015,9946,9448,498,5
18077,2015,15325,14581,744,4.9
18079,2015,13167,12490,677,5.1
18081,2015,77582,74412,3170,4.1
18083,2015,19026,18152,874,4.6
18085,2015,40660,39003,1657,4.1
18087,2015,18900,18207,693,3.7
18089,2015,229721,214026,15695,6.8
18091,2015,48520,45471,3049,6.3
18093,2015,20277,18946,1331,6.6
18095,2015,58221,54909,3312,5.7
18097,2015,472330,448309,24021,5.1
18099,2015,24007,23003,1004,4.2
18101,2015,5047,4834,213,4.2
18103,2015,15750,14929,821,5.2
18105,2015,67368,64048,3320,4.9
18107,2015,19265,18494,771,4
18109,2015,35367,33698,1669,4.7
18111,2015,6961,6556,405,5.8
18113,2015,23650,22639,1011,4.3
18115,2015,3178,3002,176,5.5
18117,2015,8726,8204,522,6
18119,2015,9285,8699,586,6.3
18121,2015,7052,6653,399,5.7
18123,2015,9231,8795,436,4.7
18125,2015,6188,5918,270,4.4
18127,2015,84702,80147,4555,5.4
18129,2015,13299,12770,529,4
18131,2015,6273,5989,284,4.5
18133,2015,16400,15560,840,5.1
18135,2015,12686,12055,631,5
18137,2015,13633,12901,732,5.4
18139,2015,8839,8455,384,4.3
18141,2015,130398,123826,6572,5
18143,2015,10266,9705,561,5.5
18145,2015,22624,21616,1008,4.5
18147,2015,10973,10518,455,4.1
18149,2015,10547,9919,628,6
18151,2015,19978,19196,782,3.9
18153,2015,8658,8117,541,6.2
18155,2015,4854,4613,241,5
18157,2015,93112,89153,3959,4.3
18159,2015,8381,8045,336,4
18161,2015,3561,3401,160,4.5
18163,2015,92233,88290,3943,4.3
18165,2015,7227,6711,516,7.1
18167,2015,48989,45975,3014,6.2
18169,2015,15386,14648,738,4.8
18171,2015,4098,3894,204,5
18173,2015,31751,30458,1293,4.1
18175,2015,13504,12800,704,5.2
18177,2015,30644,29012,1632,5.3
18179,2015,14037,13485,552,3.9
18181,2015,13609,13055,554,4.1
18183,2015,17017,16316,701,4.1
19001,2015,4218,4081,137,3.2
19003,2015,2286,2222,64,2.8
19005,2015,7686,7310,376,4.9
19007,2015,6213,5908,305,4.9
19009,2015,3232,3104,128,4
19011,2015,13750,13213,537,3.9
19013,2015,70387,67159,3228,4.6
19015,2015,15290,14826,464,3
19017,2015,13948,13456,492,3.5
19019,2015,11297,10815,482,4.3
19021,2015,11566,11141,425,3.7
19023,2015,8267,7904,363,4.4
19025,2015,4449,4256,193,4.3
19027,2015,11286,10990,296,2.6
19029,2015,7446,7175,271,3.6
19031,2015,10969,10591,378,3.4
19033,2015,22974,22063,911,4
19035,2015,6333,6004,329,5.2
19037,2015,6446,6155,291,4.5
19039,2015,4762,4566,196,4.1
19041,2015,8837,8516,321,3.6
19043,2015,10276,9849,427,4.2
19045,2015,24397,23173,1224,5
19047,2015,8736,8369,367,4.2
19049,2015,43614,42360,1254,2.9
19051,2015,4170,3984,186,4.5
19053,2015,4422,4277,145,3.3
19055,2015,10669,10307,362,3.4
19057,2015,20488,19517,971,4.7
19059,2015,10194,9797,397,3.9
19061,2015,55638,53593,2045,3.7
19063,2015,5655,5444,211,3.7
19065,2015,10797,10306,491,4.5
19067,2015,8689,8359,330,3.8
19069,2015,5950,5749,201,3.4
19071,2015,4142,4005,137,3.3
19073,2015,5561,5365,196,3.5
19075,2015,6722,6466,256,3.8
19077,2015,5613,5401,212,3.8
19079,2015,7219,6911,308,4.3
19081,2015,6357,6184,173,2.7
19083,2015,8802,8453,349,4
19085,2015,7527,7271,256,3.4
19087,2015,9583,9207,376,3.9
19089,2015,5368,5175,193,3.6
19091,2015,5334,5156,178,3.3
19093,2015,3954,3831,123,3.1
19095,2015,10368,10003,365,3.5
19097,2015,11149,10679,470,4.2
19099,2015,19077,18334,743,3.9
19101,2015,9138,8786,352,3.9
19103,2015,83764,81523,2241,2.7
19105,2015,10766,10315,451,4.2
19107,2015,5416,5185,231,4.3
19109,2015,8821,8568,253,2.9
19111,2015,18243,17259,984,5.4
19113,2015,120022,115459,4563,3.8
19115,2015,6017,5788,229,3.8
19117,2015,4395,4239,156,3.5
19119,2015,7053,6911,142,2
19121,2015,8223,7900,323,3.9
19123,2015,11819,11349,470,4
19125,2015,17409,16837,572,3.3
19127,2015,19409,18422,987,5.1
19129,2015,7415,7111,304,4.1
19131,2015,5587,5429,158,2.8
19133,2015,4756,4546,210,4.4
19135,2015,4032,3853,179,4.4
19137,2015,5163,4979,184,3.6
19139,2015,22183,21322,861,3.9
19141,2015,8419,8180,239,2.8
19143,2015,3539,3438,101,2.9
19145,2015,6562,6289,273,4.2
19147,2015,4857,4707,150,3.1
19149,2015,14770,14352,418,2.8
19151,2015,4304,4173,131,3
19153,2015,255296,245868,9428,3.7
19155,2015,48930,47134,1796,3.7
19157,2015,10495,10114,381,3.6
19159,2015,2563,2477,86,3.4
19161,2015,5634,5446,188,3.3
19163,2015,87792,83677,4115,4.7
19165,2015,7009,6808,201,2.9
19167,2015,20729,20218,511,2.5
19169,2015,57348,55909,1439,2.5
19171,2015,9654,9232,422,4.4
19173,2015,3235,3132,103,3.2
19175,2015,6566,6291,275,4.2
19177,2015,3836,3680,156,4.1
19179,2015,17986,17057,929,5.2
19181,2015,26671,25754,917,3.4
19183,2015,12374,11986,388,3.1
19185,2015,2846,2734,112,3.9
19187,2015,20325,19445,880,4.3
19189,2015,5163,4957,206,4
19191,2015,12210,11762,448,3.7
19193,2015,56119,53993,2126,3.8
19195,2015,4222,4053,169,4
19197,2015,6897,6627,270,3.9
20001,2015,6605,6266,339,5.1
20003,2015,4134,3934,200,4.8
20005,2015,7470,7011,459,6.1
20007,2015,2662,2549,113,4.2
20009,2015,14588,13972,616,4.2
20011,2015,7117,6776,341,4.8
20013,2015,5354,5141,213,4
20015,2015,32029,30662,1367,4.3
20017,2015,1252,1207,45,3.6
20019,2015,1551,1463,88,5.7
20021,2015,10412,9949,463,4.4
20023,2015,1357,1320,37,2.7
20025,2015,1159,1131,28,2.4
20027,2015,4116,3939,177,4.3
20029,2015,4311,4147,164,3.8
20031,2015,4739,4468,271,5.7
20033,2015,991,958,33,3.3
20035,2015,17039,16259,780,4.6
20037,2015,18924,17959,965,5.1
20039,2015,1350,1301,49,3.6
20041,2015,9519,9026,493,5.2
20043,2015,4318,4131,187,4.3
20045,2015,64751,62358,2393,3.7
20047,2015,1749,1696,53,3
20049,2015,1279,1218,61,4.8
20051,2015,17518,16994,524,3
20053,2015,2938,2830,108,3.7
20055,2015,20126,19415,711,3.5
20057,2015,18058,17444,614,3.4
20059,2015,14099,13453,646,4.6
20061,2015,12109,11358,751,6.2
20063,2015,1486,1449,37,2.5
20065,2015,1272,1222,50,3.9
20067,2015,3902,3762,140,3.6
20069,2015,3600,3517,83,2.3
20071,2015,934,914,20,2.1
20073,2015,3289,3138,151,4.6
20075,2015,1652,1619,33,2
20077,2015,2855,2744,111,3.9
20079,2015,17206,16534,672,3.9
20081,2015,2358,2299,59,2.5
20083,2015,1027,995,32,3.1
20085,2015,7239,6970,269,3.7
20087,2015,10185,9758,427,4.2
20089,2015,1374,1314,60,4.4
20091,2015,324639,313637,11002,3.4
20093,2015,2147,2080,67,3.1
20095,2015,3648,3490,158,4.3
20097,2015,1448,1405,43,3
20099,2015,10753,10135,618,5.7
20101,2015,878,849,29,3.3
20103,2015,35267,33677,1590,4.5
20105,2015,1797,1735,62,3.5
20107,2015,4328,4050,278,6.4
20109,2015,1755,1712,43,2.5
20111,2015,16633,15919,714,4.3
20113,2015,17179,16665,514,3
20115,2015,6161,5928,233,3.8
20117,2015,5734,5567,167,2.9
20119,2015,2418,2346,72,3
20121,2015,16755,16028,727,4.3
20123,2015,3774,3649,125,3.3
20125,2015,16575,15503,1072,6.5
20127,2015,3104,2971,133,4.3
20129,2015,1435,1375,60,4.2
20131,2015,5937,5785,152,2.6
20133,2015,6268,5801,467,7.5
20135,2015,1537,1486,51,3.3
20137,2015,2949,2876,73,2.5
20139,2015,8056,7654,402,5
20141,2015,2090,2017,73,3.5
20143,2015,3229,3107,122,3.8
20145,2015,3306,3183,123,3.7
20147,2015,2954,2859,95,3.2
20149,2015,11952,11516,436,3.6
20151,2015,5290,5076,214,4
20153,2015,1535,1500,35,2.3
20155,2015,30837,29507,1330,4.3
20157,2015,2589,2518,71,2.7
20159,2015,5477,5270,207,3.8
20161,2015,35625,34406,1219,3.4
20163,2015,2809,2680,129,4.6
20165,2015,1794,1731,63,3.5
20167,2015,3732,3593,139,3.7
20169,2015,30867,29704,1163,3.8
20171,2015,2885,2805,80,2.8
20173,2015,246743,234963,11780,4.8
20175,2015,10621,10163,458,4.3
20177,2015,91219,87347,3872,4.2
20179,2015,1482,1449,33,2.2
20181,2015,3090,3000,90,2.9
20183,2015,2093,2012,81,3.9
20185,2015,2182,2095,87,4
20187,2015,1061,1029,32,3
20189,2015,3178,3059,119,3.7
20191,2015,11077,10584,493,4.5
20193,2015,4415,4298,117,2.7
20195,2015,1508,1455,53,3.5
20197,2015,3732,3588,144,3.9
20199,2015,877,853,24,2.7
20201,2015,3128,3030,98,3.1
20203,2015,1255,1218,37,2.9
20205,2015,4007,3744,263,6.6
20207,2015,1611,1530,81,5
20209,2015,76144,71563,4581,6
21001,2015,7227,6709,518,7.2
21003,2015,8674,8252,422,4.9
21005,2015,11346,10879,467,4.1
21007,2015,3604,3356,248,6.9
21009,2015,18446,17491,955,5.2
21011,2015,4689,4328,361,7.7
21013,2015,8730,7981,749,8.6
21015,2015,65668,62999,2669,4.1
21017,2015,9750,9290,460,4.7
21019,2015,18320,17063,1257,6.9
21021,2015,12027,11362,665,5.5
21023,2015,3727,3493,234,6.3
21025,2015,3819,3444,375,9.800000000000001
21027,2015,7660,7187,473,6.2
21029,2015,39451,37662,1789,4.5
21031,2015,5096,4796,300,5.9
21033,2015,5302,5007,295,5.6
21035,2015,18561,17698,863,4.6
21037,2015,47828,45852,1976,4.1
21039,2015,2228,2097,131,5.9
21041,2015,5011,4734,277,5.5
21043,2015,9944,8940,1004,10.1
21045,2015,6510,6134,376,5.8
21047,2015,24956,23374,1582,6.3
21049,2015,16884,16006,878,5.2
21051,2015,5290,4777,513,9.699999999999999
21053,2015,3795,3478,317,8.4
21055,2015,3721,3514,207,5.6
21057,2015,2870,2697,173,6
21059,2015,45635,43539,2096,4.6
21061,2015,4685,4356,329,7
21063,2015,2039,1829,210,10.3
21065,2015,5197,4875,322,6.2
21067,2015,168040,161603,6437,3.8
21069,2015,6078,5693,385,6.3
21071,2015,11567,10471,1096,9.5
21073,2015,24334,23300,1034,4.2
21075,2015,2065,1906,159,7.7
21077,2015,3845,3647,198,5.1
21079,2015,7498,7110,388,5.2
21081,2015,11096,10506,590,5.3
21083,2015,15129,14187,942,6.2
21085,2015,10513,9806,707,6.7
21087,2015,4968,4703,265,5.3
21089,2015,13753,12707,1046,7.6
21091,2015,3891,3698,193,5
21093,2015,46631,44322,2309,5
21095,2015,6997,6109,888,12.7
21097,2015,8329,7941,388,4.7
21099,2015,7671,7277,394,5.1
21101,2015,21433,20400,1033,4.8
21103,2015,7668,7311,357,4.7
21105,2015,1928,1811,117,6.1
21107,2015,19132,18033,1099,5.7
21109,2015,4194,3819,375,8.9
21111,2015,377768,359717,18051,4.8
21113,2015,25282,24224,1058,4.2
21115,2015,7167,6533,634,8.800000000000001
21117,2015,83326,79649,3677,4.4
21119,2015,4715,4233,482,10.2
21121,2015,9741,8942,799,8.199999999999999
21123,2015,5863,5564,299,5.1
21125,2015,23402,21939,1463,6.3
21127,2015,4976,4500,476,9.6
21129,2015,1977,1805,172,8.699999999999999
21131,2015,2872,2551,321,11.2
21133,2015,6613,5845,768,11.6
21135,2015,4795,4369,426,8.9
21137,2015,9040,8430,610,6.7
21139,2015,3682,3417,265,7.2
21141,2015,11457,10906,551,4.8
21143,2015,2867,2702,165,5.8
21145,2015,28758,27109,1649,5.7
21147,2015,4638,4244,394,8.5
21149,2015,4259,4050,209,4.9
21151,2015,45226,43279,1947,4.3
21153,2015,3329,2804,525,15.8
21155,2015,9126,8676,450,4.9
21157,2015,14820,13989,831,5.6
21159,2015,3090,2780,310,10
21161,2015,7294,6844,450,6.2
21163,2015,11795,11139,656,5.6
21165,2015,2356,2153,203,8.6
21167,2015,9683,9194,489,5.1
21169,2015,4024,3815,209,5.2
21171,2015,4494,4296,198,4.4
21173,2015,11717,10946,771,6.6
21175,2015,4411,4043,368,8.300000000000001
21177,2015,11514,10680,834,7.2
21179,2015,21034,19968,1066,5.1
21181,2015,3178,2979,199,6.3
21183,2015,9316,8722,594,6.4
21185,2015,30960,29755,1205,3.9
21187,2015,5374,5151,223,4.1
21189,2015,1139,1023,116,10.2
21191,2015,6678,6322,356,5.3
21193,2015,8810,8009,801,9.1
21195,2015,20870,18930,1940,9.300000000000001
21197,2015,4862,4517,345,7.1
21199,2015,25467,23962,1505,5.9
21201,2015,781,730,51,6.5
21203,2015,6879,6439,440,6.4
21205,2015,10300,9688,612,5.9
21207,2015,6150,5427,723,11.8
21209,2015,26937,25875,1062,3.9
21211,2015,22914,21993,921,4
21213,2015,8329,7930,399,4.8
21215,2015,9265,8869,396,4.3
21217,2015,11783,11074,709,6
21219,2015,5235,4982,253,4.8
21221,2015,5730,5402,328,5.7
21223,2015,3844,3628,216,5.6
21225,2015,6132,5717,415,6.8
21227,2015,59510,56848,2662,4.5
21229,2015,5959,5693,266,4.5
21231,2015,7037,6463,574,8.199999999999999
21233,2015,5964,5652,312,5.2
21235,2015,13130,12238,892,6.8
21237,2015,1910,1716,194,10.2
21239,2015,14383,13879,504,3.5
22001,2015,25807,24039,1768,6.9
22003,2015,8821,8207,614,7
22005,2015,61625,58505,3120,5.1
22007,2015,9799,9026,773,7.9
22009,2015,15958,14757,1201,7.5
22011,2015,15188,14224,964,6.3
22013,2015,5801,5318,483,8.300000000000001
22015,2015,58158,54869,3289,5.7
22017,2015,110251,102368,7883,7.2
22019,2015,99173,93820,5353,5.4
22021,2015,4025,3691,334,8.300000000000001
22023,2015,3666,3495,171,4.7
22025,2015,3613,3265,348,9.6
22027,2015,6185,5731,454,7.3
22029,2015,7539,6885,654,8.699999999999999
22031,2015,11075,10190,885,8
22033,2015,235008,222242,12766,5.4
22035,2015,2216,1903,313,14.1
22037,2015,8209,7720,489,6
22039,2015,12985,12005,980,7.5
22041,2015,7519,6789,730,9.699999999999999
22043,2015,8471,7849,622,7.3
22045,2015,31817,29232,2585,8.1
22047,2015,14402,13348,1054,7.3
22049,2015,7252,6817,435,6
22051,2015,219385,206759,12626,5.8
22053,2015,13593,12750,843,6.2
22055,2015,120044,113224,6820,5.7
22057,2015,46617,44091,2526,5.4
22059,2015,6603,6147,456,6.9
22061,2015,21053,19580,1473,7
22063,2015,68263,64761,3502,5.1
22065,2015,3902,3539,363,9.300000000000001
22067,2015,10818,9627,1191,11
22069,2015,16565,15304,1261,7.6
22071,2015,181971,170104,11867,6.5
22073,2015,72254,67444,4810,6.7
22075,2015,10324,9745,579,5.6
22077,2015,10123,9453,670,6.6
22079,2015,58175,54412,3763,6.5
22081,2015,3915,3644,271,6.9
22083,2015,8663,7905,758,8.699999999999999
22085,2015,9474,8797,677,7.1
22087,2015,19716,18413,1303,6.6
22089,2015,25606,24139,1467,5.7
22091,2015,4530,4118,412,9.1
22093,2015,9802,8970,832,8.5
22095,2015,20373,18846,1527,7.5
22097,2015,33775,31058,2717,8
22099,2015,24072,22414,1658,6.9
22101,2015,24259,22409,1850,7.6
22103,2015,117427,111093,6334,5.4
22105,2015,54206,50284,3922,7.2
22107,2015,1717,1549,168,9.800000000000001
22109,2015,52997,49827,3170,6
22111,2015,9352,8682,670,7.2
22113,2015,25831,24036,1795,6.9
22115,2015,17427,16070,1357,7.8
22117,2015,17039,15737,1302,7.6
22119,2015,15578,14202,1376,8.800000000000001
22121,2015,13254,12511,743,5.6
22123,2015,4122,3567,555,13.5
22125,2015,5404,5118,286,5.3
22127,2015,5337,4885,452,8.5
23001,2015,54797,52513,2284,4.2
23003,2015,31701,29826,1875,5.9
23005,2015,157894,152480,5414,3.4
23007,2015,14533,13841,692,4.8
23009,2015,29055,27438,1617,5.6
23011,2015,61616,59007,2609,4.2
23013,2015,20471,19633,838,4.1
23015,2015,16724,15982,742,4.4
23017,2015,26526,25085,1441,5.4
23019,2015,76851,73218,3633,4.7
23021,2015,7451,7040,411,5.5
23023,2015,18931,18266,665,3.5
23025,2015,23629,22084,1545,6.5
23027,2015,20613,19541,1072,5.2
23029,2015,13989,13098,891,6.4
23031,2015,108464,104208,4256,3.9
24001,2015,32287,30038,2249,7
24003,2015,300913,287705,13208,4.4
24005,2015,444951,421458,23493,5.3
24009,2015,47011,44856,2155,4.6
24011,2015,17471,16519,952,5.4
24013,2015,93045,89128,3917,4.2
24015,2015,52582,49436,3146,6
24017,2015,80510,76509,4001,5
24019,2015,15805,14675,1130,7.1
24021,2015,128523,122786,5737,4.5
24023,2015,15639,14654,985,6.3
24025,2015,135870,129201,6669,4.9
24027,2015,176731,170009,6722,3.8
24029,2015,10574,10011,563,5.3
24031,2015,547383,526091,21292,3.9
24033,2015,486583,461112,25471,5.2
24035,2015,26622,25423,1199,4.5
24037,2015,54587,51943,2644,4.8
24039,2015,9225,8467,758,8.199999999999999
24041,2015,19267,18323,944,4.9
24043,2015,76681,72386,4295,5.6
24045,2015,50226,46822,3404,6.8
24047,2015,25464,22775,2689,10.6
24510,2015,293652,271532,22120,7.5
25001,2015,111570,104767,6803,6.1
25003,2015,65098,61582,3516,5.4
25005,2015,289836,272112,17724,6.1
25007,2015,9456,8839,617,6.5
25009,2015,407755,387402,20353,5
25011,2015,39434,37705,1729,4.4
25013,2015,222643,208420,14223,6.4
25015,2015,87345,83414,3931,4.5
25017,2015,863351,829555,33796,3.9
25019,2015,6967,6592,375,5.4
25021,2015,369156,353791,15365,4.2
25023,2015,268265,254727,13538,5
25025,2015,420905,402385,18520,4.4
25027,2015,427532,405821,21711,5.1
26001,2015,3805,3496,309,8.1
26003,2015,3230,2951,279,8.6
26005,2015,60441,57906,2535,4.2
26007,2015,13615,12754,861,6.3
26009,2015,9988,9233,755,7.6
26011,2015,6227,5662,565,9.1
26013,2015,3297,2992,305,9.300000000000001
26015,2015,30202,28892,1310,4.3
26017,2015,52192,49142,3050,5.8
26019,2015,8674,8061,613,7.1
26021,2015,73367,69500,3867,5.3
26023,2015,19139,18149,990,5.2
26025,2015,64129,60821,3308,5.2
26027,2015,24008,22779,1229,5.1
26029,2015,13044,12247,797,6.1
26031,2015,10686,9698,988,9.199999999999999
26033,2015,16690,15375,1315,7.9
26035,2015,11779,10855,924,7.8
26037,2015,39722,38146,1576,4
26039,2015,5273,4855,418,7.9
26041,2015,17237,16052,1185,6.9
26043,2015,12600,11879,721,5.7
26045,2015,55831,53330,2501,4.5
26047,2015,17632,16344,1288,7.3
26049,2015,181692,170490,11202,6.2
26051,2015,9976,9241,735,7.4
26053,2015,6493,6012,481,7.4
26055,2015,48427,46139,2288,4.7
26057,2015,18285,17235,1050,5.7
26059,2015,21018,19901,1117,5.3
26061,2015,16562,15497,1065,6.4
26063,2015,16358,15465,893,5.5
26065,2015,145756,138866,6890,4.7
26067,2015,29343,27986,1357,4.6
26069,2015,10094,9324,770,7.6
26071,2015,5206,4834,372,7.1
26073,2015,35288,33572,1716,4.9
26075,2015,73010,69100,3910,5.4
26077,2015,129087,123401,5686,4.4
26079,2015,7626,7033,593,7.8
26081,2015,342291,329249,13042,3.8
26083,2015,940,852,88,9.4
26085,2015,3679,3359,320,8.699999999999999
26087,2015,39785,36950,2835,7.1
26089,2015,10578,10015,563,5.3
26091,2015,47453,45046,2407,5.1
26093,2015,96610,92191,4419,4.6
26095,2015,2459,2285,174,7.1
26097,2015,5124,4619,505,9.9
26099,2015,422184,398130,24054,5.7
26101,2015,10404,9703,701,6.7
26103,2015,33372,31344,2028,6.1
26105,2015,14410,13518,892,6.2
26107,2015,19135,17943,1192,6.2
26109,2015,11523,10894,629,5.5
26111,2015,41413,39370,2043,4.9
26113,2015,6986,6523,463,6.6
26115,2015,76190,72674,3516,4.6
26117,2015,27675,26069,1606,5.8
26119,2015,3067,2757,310,10.1
26121,2015,77281,72723,4558,5.9
26123,2015,23070,21793,1277,5.5
26125,2015,633925,604308,29617,4.7
26127,2015,12486,11475,1011,8.1
26129,2015,8406,7737,669,8
26131,2015,2294,2076,218,9.5
26133,2015,10158,9488,670,6.6
26135,2015,2910,2655,255,8.800000000000001
26137,2015,11404,10695,709,6.2
26139,2015,152319,146713,5606,3.7
26141,2015,5359,4806,553,10.3
26143,2015,7808,7094,714,9.1
26145,2015,88375,83275,5100,5.8
26147,2015,72934,68010,4924,6.8
26149,2015,29029,27704,1325,4.6
26151,2015,19500,18215,1285,6.6
26153,2015,3459,3080,379,11
26155,2015,33068,31175,1893,5.7
26157,2015,24520,22856,1664,6.8
26159,2015,35223,32985,2238,6.4
26161,2015,188324,181238,7086,3.8
26163,2015,760134,708069,52065,6.8
26165,2015,14572,13576,996,6.8
27001,2015,6877,6427,450,6.5
27003,2015,189980,183128,6852,3.6
27005,2015,18412,17608,804,4.4
27007,2015,23518,22367,1151,4.9
27009,2015,21604,20646,958,4.4
27011,2015,2684,2565,119,4.4
27013,2015,39407,38248,1159,2.9
27015,2015,14630,14033,597,4.1
27017,2015,17583,16720,863,4.9
27019,2015,55215,53469,1746,3.2
27021,2015,14039,13103,936,6.7
27023,2015,6950,6646,304,4.4
27025,2015,28753,27556,1197,4.2
27027,2015,35570,34468,1102,3.1
27029,2015,4631,4211,420,9.1
27031,2015,3156,3018,138,4.4
27033,2015,5792,5517,275,4.7
27035,2015,31518,29897,1621,5.1
27037,2015,232437,224785,7652,3.3
27039,2015,11461,11035,426,3.7
27041,2015,20151,19464,687,3.4
27043,2015,7508,7180,328,4.4
27045,2015,11413,10948,465,4.1
27047,2015,16355,15739,616,3.8
27049,2015,26897,25954,943,3.5
27051,2015,3349,3192,157,4.7
27053,2015,677303,655117,22186,3.3
27055,2015,10492,10093,399,3.8
27057,2015,9561,8977,584,6.1
27059,2015,20212,19344,868,4.3
27061,2015,22311,20869,1442,6.5
27063,2015,6292,6039,253,4
27065,2015,8840,8259,581,6.6
27067,2015,24079,23181,898,3.7
27069,2015,2474,2360,114,4.6
27071,2015,6258,5750,508,8.1
27073,2015,3766,3612,154,4.1
27075,2015,5614,5346,268,4.8
27077,2015,2423,2316,107,4.4
27079,2015,15547,14799,748,4.8
27081,2015,3394,3275,119,3.5
27083,2015,15296,14805,491,3.2
27085,2015,20216,19423,793,3.9
27087,2015,2407,2268,139,5.8
27089,2015,5747,5351,396,6.9
27091,2015,10454,10030,424,4.1
27093,2015,13349,12790,559,4.2
27095,2015,12622,11892,730,5.8
27097,2015,17808,16848,960,5.4
27099,2015,20377,19724,653,3.2
27101,2015,5066,4842,224,4.4
27103,2015,20321,19786,535,2.6
27105,2015,11534,11165,369,3.2
27107,2015,3443,3283,160,4.6
27109,2015,83958,81513,2445,2.9
27111,2015,31139,29833,1306,4.2
27113,2015,9084,8619,465,5.1
27115,2015,14793,13972,821,5.5
27117,2015,4980,4814,166,3.3
27119,2015,17176,16453,723,4.2
27121,2015,6393,6171,222,3.5
27123,2015,279777,269936,9841,3.5
27125,2015,2331,2194,137,5.9
27127,2015,8274,7951,323,3.9
27129,2015,8598,8186,412,4.8
27131,2015,35448,34196,1252,3.5
27133,2015,5913,5788,125,2.1
27135,2015,8608,8267,341,4
27137,2015,101997,96945,5052,5
27139,2015,79212,76741,2471,3.1
27141,2015,49504,47525,1979,4
27143,2015,8515,8163,352,4.1
27145,2015,88195,85015,3180,3.6
27147,2015,21216,20510,706,3.3
27149,2015,5713,5553,160,2.8
27151,2015,5175,4864,311,6
27153,2015,13017,12448,569,4.4
27155,2015,1837,1761,76,4.1
27157,2015,12000,11548,452,3.8
27159,2015,6333,5959,374,5.9
27161,2015,9759,9356,403,4.1
27163,2015,137250,132922,4328,3.2
27165,2015,6256,5964,292,4.7
27167,2015,3692,3570,122,3.3
27169,2015,29493,28518,975,3.3
27171,2015,72032,69391,2641,3.7
27173,2015,5579,5375,204,3.7
28001,2015,11420,10515,905,7.9
28003,2015,15734,14853,881,5.6
28005,2015,4517,4177,340,7.5
28007,2015,6989,6460,529,7.6
28009,2015,2986,2749,237,7.9
28011,2015,13399,12352,1047,7.8
28013,2015,6143,5766,377,6.1
28015,2015,3463,3181,282,8.1
28017,2015,7155,6609,546,7.6
28019,2015,3714,3483,231,6.2
28021,2015,3120,2730,390,12.5
28023,2015,6081,5606,475,7.8
28025,2015,8023,7259,764,9.5
28027,2015,9457,8510,947,10
28029,2015,11268,10459,809,7.2
28031,2015,7973,7509,464,5.8
28033,2015,84635,80597,4038,4.8
28035,2015,32866,30812,2054,6.2
28037,2015,2940,2716,224,7.6
28039,2015,8864,8203,661,7.5
28041,2015,4333,4008,325,7.5
28043,2015,9487,8927,560,5.9
28045,2015,18690,17486,1204,6.4
28047,2015,85716,80657,5059,5.9
28049,2015,109303,102755,6548,6
28051,2015,6119,5387,732,12
28053,2015,2469,2158,311,12.6
28055,2015,419,348,71,16.9
28057,2015,10218,9637,581,5.7
28059,2015,59015,54887,4128,7
28061,2015,6369,5873,496,7.8
28063,2015,2278,1940,338,14.8
28065,2015,4131,3773,358,8.699999999999999
28067,2015,26572,24988,1584,6
28069,2015,3579,3210,369,10.3
28071,2015,24466,23137,1329,5.4
28073,2015,28925,27541,1384,4.8
28075,2015,31683,29618,2065,6.5
28077,2015,4749,4408,341,7.2
28079,2015,7898,7414,484,6.1
28081,2015,39891,37689,2202,5.5
28083,2015,10496,9373,1123,10.7
28085,2015,14237,13378,859,6
28087,2015,25140,23384,1756,7
28089,2015,51688,49338,2350,4.5
28091,2015,10016,9289,727,7.3
28093,2015,14454,13418,1036,7.2
28095,2015,15494,14358,1136,7.3
28097,2015,4202,3879,323,7.7
28099,2015,10631,9983,648,6.1
28101,2015,8726,8194,532,6.1
28103,2015,3956,3571,385,9.699999999999999
28105,2015,22513,21143,1370,6.1
28107,2015,13448,12285,1163,8.6
28109,2015,22886,21484,1402,6.1
28111,2015,4318,3976,342,7.9
28113,2015,14707,13638,1069,7.3
28115,2015,13887,13117,770,5.5
28117,2015,11002,10340,662,6
28119,2015,2689,2401,288,10.7
28121,2015,73073,70061,3012,4.1
28123,2015,12994,12373,621,4.8
28125,2015,1728,1563,165,9.5
28127,2015,10907,10269,638,5.8
28129,2015,6759,6399,360,5.3
28131,2015,6413,5941,472,7.4
28133,2015,8479,7594,885,10.4
28135,2015,5813,5377,436,7.5
28137,2015,12004,11161,843,7
28139,2015,9447,8849,598,6.3
28141,2015,8018,7511,507,6.3
28143,2015,4659,4229,430,9.199999999999999
28145,2015,13223,12553,670,5.1
28147,2015,5153,4739,414,8
28149,2015,20899,19517,1382,6.6
28151,2015,18053,16208,1845,10.2
28153,2015,7626,7026,600,7.9
28155,2015,3942,3661,281,7.1
28157,2015,2884,2580,304,10.5
28159,2015,7088,6507,581,8.199999999999999
28161,2015,4931,4580,351,7.1
28163,2015,9212,8463,749,8.1
29001,2015,10439,9849,590,5.7
29003,2015,9918,9504,414,4.2
29005,2015,2831,2704,127,4.5
29007,2015,11307,10783,524,4.6
29009,2015,14907,14159,748,5
29011,2015,5325,5036,289,5.4
29013,2015,8148,7651,497,6.1
29015,2015,7189,6719,470,6.5
29017,2015,5553,5241,312,5.6
29019,2015,98827,95343,3484,3.5
29021,2015,46476,44336,2140,4.6
29023,2015,18970,17791,1179,6.2
29025,2015,4394,4193,201,4.6
29027,2015,21666,20642,1024,4.7
29029,2015,18746,17515,1231,6.6
29031,2015,40850,39084,1766,4.3
29033,2015,4816,4524,292,6.1
29035,2015,2508,2322,186,7.4
29037,2015,53865,51268,2597,4.8
29039,2015,5890,5578,312,5.3
29041,2015,3851,3670,181,4.7
29043,2015,43037,41213,1824,4.2
29045,2015,3433,3187,246,7.2
29047,2015,132146,126125,6021,4.6
29049,2015,10987,10452,535,4.9
29051,2015,39365,37786,1579,4
29053,2015,7611,7170,441,5.8
29055,2015,10905,10246,659,6
29057,2015,3568,3387,181,5.1
29059,2015,6976,6540,436,6.3
29061,2015,4084,3897,187,4.6
29063,2015,5048,4812,236,4.7
29065,2015,6297,5929,368,5.8
29067,2015,5037,4694,343,6.8
29069,2015,13119,12061,1058,8.1
29071,2015,52507,49836,2671,5.1
29073,2015,7679,7352,327,4.3
29075,2015,3613,3461,152,4.2
29077,2015,149242,143020,6222,4.2
29079,2015,4909,4705,204,4.2
29081,2015,3984,3782,202,5.1
29083,2015,10105,9554,551,5.5
29085,2015,3721,3473,248,6.7
29087,2015,2708,2610,98,3.6
29089,2015,5043,4796,247,4.9
29091,2015,16343,15289,1054,6.4
29093,2015,3850,3544,306,7.9
29095,2015,362912,341432,21480,5.9
29097,2015,58043,55550,2493,4.3
29099,2015,117612,111882,5730,4.9
29101,2015,23102,21855,1247,5.4
29103,2015,1963,1886,77,3.9
29105,2015,15929,14915,1014,6.4
29107,2015,17174,16339,835,4.9
29109,2015,17876,16997,879,4.9
29111,2015,5210,4953,257,4.9
29113,2015,26945,25550,1395,5.2
29115,2015,5241,4872,369,7
29117,2015,7302,6990,312,4.3
29119,2015,10407,9912,495,4.8
29121,2015,7468,7069,399,5.3
29123,2015,5516,5191,325,5.9
29125,2015,3935,3726,209,5.3
29127,2015,14745,14087,658,4.5
29129,2015,1887,1803,84,4.5
29131,2015,11648,10945,703,6
29133,2015,6281,5916,365,5.8
29135,2015,7397,7033,364,4.9
29137,2015,4209,3989,220,5.2
29139,2015,5705,5421,284,5
29141,2015,8073,7528,545,6.8
29143,2015,8578,8043,535,6.2
29145,2015,28429,27126,1303,4.6
29147,2015,11010,10467,543,4.9
29149,2015,4161,3897,264,6.3
29151,2015,7156,6887,269,3.8
29153,2015,3646,3355,291,8
29155,2015,7040,6401,639,9.1
29157,2015,10206,9775,431,4.2
29159,2015,20918,19814,1104,5.3
29161,2015,19560,18517,1043,5.3
29163,2015,8106,7734,372,4.6
29165,2015,55417,53082,2335,4.2
29167,2015,14253,13499,754,5.3
29169,2015,14885,14013,872,5.9
29171,2015,2499,2399,100,4
29173,2015,5669,5428,241,4.3
29175,2015,10502,9870,632,6
29177,2015,11160,10547,613,5.5
29179,2015,2712,2522,190,7
29181,2015,5323,4899,424,8
29183,2015,217502,209114,8388,3.9
29185,2015,3976,3699,277,7
29186,2015,9059,8573,486,5.4
29187,2015,26398,24787,1611,6.1
29189,2015,533457,508678,24779,4.6
29195,2015,11049,10515,534,4.8
29197,2015,1907,1796,111,5.8
29199,2015,2451,2339,112,4.6
29201,2015,20043,18991,1052,5.2
29203,2015,3337,3064,273,8.199999999999999
29205,2015,3076,2930,146,4.7
29207,2015,13229,12351,878,6.6
29209,2015,13367,12308,1059,7.9
29211,2015,2777,2612,165,5.9
29213,2015,26161,24043,2118,8.1
29215,2015,9403,8776,627,6.7
29217,2015,9816,9316,500,5.1
29219,2015,17338,16506,832,4.8
29221,2015,10520,9812,708,6.7
29223,2015,5716,5379,337,5.9
29225,2015,16648,15798,850,5.1
29227,2015,1217,1177,40,3.3
29229,2015,7641,7161,480,6.3
29510,2015,159676,149964,9712,6.1
30001,2015,4980,4809,171,3.4
30003,2015,5551,5179,372,6.7
30005,2015,2396,2276,120,5
30007,2015,2484,2358,126,5.1
30009,2015,5425,5225,200,3.7
30011,2015,685,663,22,3.2
30013,2015,38302,36752,1550,4
30015,2015,2524,2441,83,3.3
30017,2015,6389,6178,211,3.3
30019,2015,944,920,24,2.5
30021,2015,4821,4669,152,3.2
30023,2015,5236,5027,209,4
30025,2015,1970,1924,46,2.3
30027,2015,5701,5465,236,4.1
30029,2015,44823,42257,2566,5.7
30031,2015,59451,57662,1789,3
30033,2015,762,741,21,2.8
30035,2015,5853,5327,526,9
30037,2015,380,364,16,4.2
30039,2015,1560,1463,97,6.2
30041,2015,7795,7469,326,4.2
30043,2015,5583,5355,228,4.1
30045,2015,994,960,34,3.4
30047,2015,12697,12062,635,5
30049,2015,35007,33827,1180,3.4
30051,2015,985,959,26,2.6
30053,2015,7809,7020,789,10.1
30055,2015,1062,1039,23,2.2
30057,2015,4286,4131,155,3.6
30059,2015,936,902,34,3.6
30061,2015,1728,1583,145,8.4
30063,2015,60517,58139,2378,3.9
30065,2015,2409,2305,104,4.3
30067,2015,8300,7901,399,4.8
30069,2015,284,269,15,5.3
30071,2015,1977,1877,100,5.1
30073,2015,2866,2738,128,4.5
30075,2015,1056,1029,27,2.6
30077,2015,2960,2828,132,4.5
30079,2015,529,507,22,4.2
30081,2015,19220,18217,1003,5.2
30083,2015,6879,6657,222,3.2
30085,2015,4692,4446,246,5.2
30087,2015,4176,3952,224,5.4
30089,2015,4703,4312,391,8.300000000000001
30091,2015,2075,2023,52,2.5
30093,2015,17131,16395,736,4.3
30095,2015,4930,4745,185,3.8
30097,2015,1789,1739,50,2.8
30099,2015,2890,2779,111,3.8
30101,2015,2298,2220,78,3.4
30103,2015,358,340,18,5
30105,2015,4391,4253,138,3.1
30107,2015,788,745,43,5.5
30109,2015,546,528,18,3.3
30111,2015,80777,78096,2681,3.3
31001,2015,16601,16082,519,3.1
31003,2015,3593,3501,92,2.6
31005,2015,224,214,10,4.5
31007,2015,440,425,15,3.4
31009,2015,268,256,12,4.5
31011,2015,3010,2936,74,2.5
31013,2015,5657,5487,170,3
31015,2015,1088,1059,29,2.7
31017,2015,1393,1342,51,3.7
31019,2015,27119,26457,662,2.4
31021,2015,3608,3477,131,3.6
31023,2015,4735,4603,132,2.8
31025,2015,13062,12628,434,3.3
31027,2015,4639,4529,110,2.4
31029,2015,2337,2292,45,1.9
31031,2015,3447,3368,79,2.3
31033,2015,5744,5619,125,2.2
31035,2015,3372,3274,98,2.9
31037,2015,5547,5402,145,2.6
31039,2015,4836,4708,128,2.6
31041,2015,6280,6140,140,2.2
31043,2015,10987,10599,388,3.5
31045,2015,5247,5111,136,2.6
31047,2015,13055,12641,414,3.2
31049,2015,1074,1047,27,2.5
31051,2015,3081,2979,102,3.3
31053,2015,19083,18461,622,3.3
31055,2015,286569,277086,9483,3.3
31057,2015,1196,1171,25,2.1
31059,2015,3207,3112,95,3
31061,2015,1510,1474,36,2.4
31063,2015,1531,1494,37,2.4
31065,2015,2727,2655,72,2.6
31067,2015,11039,10639,400,3.6
31069,2015,1196,1167,29,2.4
31071,2015,1193,1164,29,2.4
31073,2015,1073,1047,26,2.4
31075,2015,435,425,10,2.3
31077,2015,1248,1209,39,3.1
31079,2015,31573,30329,1244,3.9
31081,2015,4669,4535,134,2.9
31083,2015,1785,1747,38,2.1
31085,2015,615,601,14,2.3
31087,2015,1320,1277,43,3.3
31089,2015,5864,5724,140,2.4
31091,2015,405,388,17,4.2
31093,2015,3307,3186,121,3.7
31095,2015,4271,4155,116,2.7
31097,2015,2123,2053,70,3.3
31099,2015,3789,3705,84,2.2
31101,2015,4681,4556,125,2.7
31103,2015,660,646,14,2.1
31105,2015,2050,1977,73,3.6
31107,2015,4715,4564,151,3.2
31109,2015,167397,162978,4419,2.6
31111,2015,18525,17988,537,2.9
31113,2015,492,478,14,2.8
31115,2015,377,364,13,3.4
31117,2015,460,451,9,2
31119,2015,19195,18669,526,2.7
31121,2015,4024,3874,150,3.7
31123,2015,2649,2573,76,2.9
31125,2015,2064,2013,51,2.5
31127,2015,3687,3552,135,3.7
31129,2015,2380,2319,61,2.6
31131,2015,8194,7923,271,3.3
31133,2015,1671,1628,43,2.6
31135,2015,1834,1800,34,1.9
31137,2015,4989,4870,119,2.4
31139,2015,4164,4058,106,2.5
31141,2015,17130,16620,510,3
31143,2015,2907,2833,74,2.5
31145,2015,6098,5937,161,2.6
31147,2015,4297,4159,138,3.2
31149,2015,858,835,23,2.7
31151,2015,7274,7061,213,2.9
31153,2015,90585,88039,2546,2.8
31155,2015,10920,10584,336,3.1
31157,2015,18649,18018,631,3.4
31159,2015,8690,8438,252,2.9
31161,2015,2729,2655,74,2.7
31163,2015,1708,1658,50,2.9
31165,2015,787,767,20,2.5
31167,2015,3502,3413,89,2.5
31169,2015,2965,2895,70,2.4
31171,2015,435,422,13,3
31173,2015,2969,2811,158,5.3
31175,2015,2062,2004,58,2.8
31177,2015,10929,10601,328,3
31179,2015,5536,5395,141,2.5
31181,2015,1724,1663,61,3.5
31183,2015,562,549,13,2.3
31185,2015,7334,7122,212,2.9
32001,2015,10355,9631,724,7
32003,2015,1035380,964853,70527,6.8
32005,2015,22417,20916,1501,6.7
32007,2015,26692,25323,1369,5.1
32009,2015,524,501,23,4.4
32011,2015,995,937,58,5.8
32013,2015,8251,7763,488,5.9
32015,2015,3218,3002,216,6.7
32017,2015,1935,1818,117,6
32019,2015,21444,19424,2020,9.4
32021,2015,1625,1461,164,10.1
32023,2015,15920,14528,1392,8.699999999999999
32027,2015,2448,2280,168,6.9
32029,2015,1867,1729,138,7.4
32031,2015,225161,211167,13994,6.2
32033,2015,4722,4468,254,5.4
32510,2015,24793,23013,1780,7.2
33001,2015,31622,30571,1051,3.3
33003,2015,23812,22988,824,3.5
33005,2015,41575,40263,1312,3.2
33007,2015,14827,14183,644,4.3
33009,2015,48687,47355,1332,2.7
33011,2015,229924,221738,8186,3.6
33013,2015,81366,78869,2497,3.1
33015,2015,178892,172485,6407,3.6
33017,2015,71300,69083,2217,3.1
33019,2015,23697,23048,649,2.7
34001,2015,126187,114085,12102,9.6
34003,2015,479417,456885,22532,4.7
34005,2015,229689,217394,12295,5.4
34007,2015,252172,235856,16316,6.5
34009,2015,47967,42625,5342,11.1
34011,2015,67351,61401,5950,8.800000000000001
34013,2015,371332,345649,25683,6.9
34015,2015,148033,139055,8978,6.1
34017,2015,358908,339603,19305,5.4
34019,2015,64880,62124,2756,4.2
34021,2015,197409,187578,9831,5
34023,2015,434581,412158,22423,5.2
34025,2015,325388,308514,16874,5.2
34027,2015,259434,248081,11353,4.4
34029,2015,264781,248380,16401,6.2
34031,2015,246505,229054,17451,7.1
34033,2015,30767,28505,2262,7.4
34035,2015,172584,164707,7877,4.6
34037,2015,75876,71735,4141,5.5
34039,2015,277434,260672,16762,6
34041,2015,56614,53579,3035,5.4
35001,2015,323333,304413,18920,5.9
35003,2015,1195,1096,99,8.300000000000001
35005,2015,27803,26061,1742,6.3
35006,2015,9297,8558,739,7.9
35007,2015,6057,5696,361,6
35009,2015,21972,20906,1066,4.9
35011,2015,853,810,43,5
35013,2015,94623,87745,6878,7.3
35015,2015,29911,28448,1463,4.9
35017,2015,12510,11706,804,6.4
35019,2015,1639,1524,115,7
35021,2015,286,262,24,8.4
35023,2015,2143,2011,132,6.2
35025,2015,30008,28160,1848,6.2
35027,2015,8721,8221,500,5.7
35028,2015,8531,8189,342,4
35029,2015,11069,9163,1906,17.2
35031,2015,24373,22005,2368,9.699999999999999
35033,2015,2276,2057,219,9.6
35035,2015,25083,23541,1542,6.1
35037,2015,3281,3049,232,7.1
35039,2015,16645,15318,1327,8
35041,2015,8069,7635,434,5.4
35043,2015,62271,58163,4108,6.6
35045,2015,55800,51979,3821,6.8
35047,2015,11124,10276,848,7.6
35049,2015,73420,69519,3901,5.3
35051,2015,4041,3676,365,9
35053,2015,6558,6066,492,7.5
35055,2015,14960,13598,1362,9.1
35057,2015,5482,4989,493,9
35059,2015,1899,1817,82,4.3
35061,2015,29750,27550,2200,7.4
36001,2015,158470,151584,6886,4.3
36003,2015,20341,19019,1322,6.5
36005,2015,605128,558075,47053,7.8
36007,2015,86781,81599,5182,6
36009,2015,35212,32998,2214,6.3
36011,2015,37066,35088,1978,5.3
36013,2015,57593,54124,3469,6
36015,2015,37466,35269,2197,5.9
36017,2015,23086,21826,1260,5.5
36019,2015,35918,33828,2090,5.8
36021,2015,31407,30156,1251,4
36023,2015,23270,21901,1369,5.9
36025,2015,19498,18328,1170,6
36027,2015,143238,136810,6428,4.5
36029,2015,448642,424733,23909,5.3
36031,2015,17309,16268,1041,6
36033,2015,19970,18671,1299,6.5
36035,2015,23445,21937,1508,6.4
36037,2015,30098,28608,1490,5
36039,2015,20719,19552,1167,5.6
36041,2015,2434,2270,164,6.7
36043,2015,28416,26645,1771,6.2
36045,2015,46520,43456,3064,6.6
36047,2015,1213264,1141678,71586,5.9
36049,2015,11765,10952,813,6.9
36051,2015,31246,29605,1641,5.3
36053,2015,32888,31021,1867,5.7
36055,2015,365431,346915,18516,5.1
36057,2015,22270,20809,1461,6.6
36059,2015,697587,668154,29433,4.2
36061,2015,908849,864614,44235,4.9
36063,2015,101128,94901,6227,6.2
36065,2015,102114,96671,5443,5.3
36067,2015,222470,211509,10961,4.9
36069,2015,55062,52464,2598,4.7
36071,2015,177958,169670,8288,4.7
36073,2015,17874,16737,1137,6.4
36075,2015,54021,50145,3876,7.2
36077,2015,28703,27156,1547,5.4
36079,2015,50611,48454,2157,4.3
36081,2015,1155747,1097706,58041,5
36083,2015,81577,77787,3790,4.6
36085,2015,219238,206436,12802,5.8
36087,2015,152179,145300,6879,4.5
36089,2015,43891,40687,3204,7.3
36091,2015,116874,112028,4846,4.1
36093,2015,75747,72178,3569,4.7
36095,2015,14672,13821,851,5.8
36097,2015,8352,7800,552,6.6
36099,2015,15724,14914,810,5.2
36101,2015,43710,40957,2753,6.3
36103,2015,776167,739628,36539,4.7
36105,2015,33710,31891,1819,5.4
36107,2015,23384,22088,1296,5.5
36109,2015,50423,48207,2216,4.4
36111,2015,88339,84097,4242,4.8
36113,2015,32255,30471,1784,5.5
36115,2015,28653,27215,1438,5
36117,2015,44287,41931,2356,5.3
36119,2015,478437,456728,21709,4.5
36121,2015,18377,17342,1035,5.6
36123,2015,11742,11157,585,5
37001,2015,77305,73191,4114,5.3
37003,2015,17544,16685,859,4.9
37005,2015,4468,4195,273,6.1
37007,2015,10831,10128,703,6.5
37009,2015,12313,11576,737,6
37011,2015,7533,7088,445,5.9
37013,2015,20121,18803,1318,6.6
37015,2015,8605,7986,619,7.2
37017,2015,14742,13575,1167,7.9
37019,2015,48546,45021,3525,7.3
37021,2015,130452,124788,5664,4.3
37023,2015,39337,37136,2201,5.6
37025,2015,97639,92609,5030,5.2
37027,2015,35470,33264,2206,6.2
37029,2015,4614,4351,263,5.7
37031,2015,31343,29497,1846,5.9
37033,2015,9627,9023,604,6.3
37035,2015,75172,71050,4122,5.5
37037,2015,33397,31818,1579,4.7
37039,2015,11123,10409,714,6.4
37041,2015,5641,5240,401,7.1
37043,2015,4045,3798,247,6.1
37045,2015,46098,43167,2931,6.4
37047,2015,22614,20920,1694,7.5
37049,2015,41352,38861,2491,6
37051,2015,126281,117106,9175,7.3
37053,2015,12852,12110,742,5.8
37055,2015,20304,18797,1507,7.4
37057,2015,78758,74400,4358,5.5
37059,2015,19854,18860,994,5
37061,2015,26495,24984,1511,5.7
37063,2015,156659,148846,7813,5
37065,2015,22821,20647,2174,9.5
37067,2015,179781,169932,9849,5.5
37069,2015,28722,27030,1692,5.9
37071,2015,102813,96663,6150,6
37073,2015,5146,4865,281,5.5
37075,2015,3186,2806,380,11.9
37077,2015,28540,27137,1403,4.9
37079,2015,9482,8960,522,5.5
37081,2015,256352,241375,14977,5.8
37083,2015,20774,18952,1822,8.800000000000001
37085,2015,50259,46907,3352,6.7
37087,2015,27660,26213,1447,5.2
37089,2015,50676,48281,2395,4.7
37091,2015,9224,8576,648,7
37093,2015,19834,18268,1566,7.9
37095,2015,2145,1950,195,9.1
37097,2015,82207,77713,4494,5.5
37099,2015,18469,17350,1119,6.1
37101,2015,88186,83599,4587,5.2
37103,2015,4549,4288,261,5.7
37105,2015,26095,24222,1873,7.2
37107,2015,27747,25996,1751,6.3
37109,2015,40624,38431,2193,5.4
37111,2015,21266,20103,1163,5.5
37113,2015,15124,14196,928,6.1
37115,2015,9473,8936,537,5.7
37117,2015,9718,8976,742,7.6
37119,2015,565437,535313,30124,5.3
37121,2015,6312,5882,430,6.8
37123,2015,11628,10970,658,5.7
37125,2015,38300,36091,2209,5.8
37127,2015,43873,40694,3179,7.2
37129,2015,113423,107379,6044,5.3
37131,2015,7868,7278,590,7.5
37133,2015,63769,60028,3741,5.9
37135,2015,73397,70017,3380,4.6
37137,2015,5337,5020,317,5.9
37139,2015,17454,16195,1259,7.2
37141,2015,26023,24445,1578,6.1
37143,2015,5157,4791,366,7.1
37145,2015,17888,16680,1208,6.8
37147,2015,87711,82426,5285,6
37149,2015,8664,8225,439,5.1
37151,2015,66661,62877,3784,5.7
37153,2015,16929,15596,1333,7.9
37155,2015,51053,46751,4302,8.4
37157,2015,41130,38423,2707,6.6
37159,2015,63109,59288,3821,6.1
37161,2015,25055,23118,1937,7.7
37163,2015,29551,27811,1740,5.9
37165,2015,11860,10609,1251,10.5
37167,2015,28805,27280,1525,5.3
37169,2015,21810,20632,1178,5.4
37171,2015,33338,31541,1797,5.4
37173,2015,6776,6259,517,7.6
37175,2015,13550,12817,733,5.4
37177,2015,1547,1401,146,9.4
37179,2015,112359,106944,5415,4.8
37181,2015,18049,16511,1538,8.5
37183,2015,539667,514376,25291,4.7
37185,2015,7213,6618,595,8.199999999999999
37187,2015,4967,4538,429,8.6
37189,2015,27401,26080,1321,4.8
37191,2015,53745,50503,3242,6
37193,2015,29636,27962,1674,5.6
37195,2015,36753,33280,3473,9.4
37197,2015,17495,16623,872,5
37199,2015,7417,6982,435,5.9
38001,2015,1107,1074,33,3
38003,2015,5629,5448,181,3.2
38005,2015,2473,2359,114,4.6
38007,2015,467,453,14,3
38009,2015,3234,3092,142,4.4
38011,2015,1858,1823,35,1.9
38013,2015,1178,1139,39,3.3
38015,2015,48832,47665,1167,2.4
38017,2015,95126,92985,2141,2.3
38019,2015,2055,1998,57,2.8
38021,2015,2545,2498,47,1.8
38023,2015,1810,1777,33,1.8
38025,2015,4008,3929,79,2
38027,2015,1267,1206,61,4.8
38029,2015,1548,1471,77,5
38031,2015,1625,1578,47,2.9
38033,2015,975,953,22,2.3
38035,2015,37413,36498,915,2.4
38037,2015,1316,1274,42,3.2
38039,2015,1152,1125,27,2.3
38041,2015,1551,1512,39,2.5
38043,2015,1339,1290,49,3.7
38045,2015,2265,2209,56,2.5
38047,2015,946,919,27,2.9
38049,2015,3271,3133,138,4.2
38051,2015,1241,1202,39,3.1
38053,2015,9181,8952,229,2.5
38055,2015,4910,4726,184,3.7
38057,2015,4297,4116,181,4.2
38059,2015,16223,15722,501,3.1
38061,2015,8122,7962,160,2
38063,2015,1514,1457,57,3.8
38065,2015,880,828,52,5.9
38067,2015,3600,3407,193,5.4
38069,2015,1834,1757,77,4.2
38071,2015,5675,5482,193,3.4
38073,2015,2769,2701,68,2.5
38075,2015,1335,1290,45,3.4
38077,2015,8577,8342,235,2.7
38079,2015,4876,4372,504,10.3
38081,2015,2250,2209,41,1.8
38083,2015,724,687,37,5.1
38085,2015,1291,1234,57,4.4
38087,2015,463,451,12,2.6
38089,2015,20236,19687,549,2.7
38091,2015,1060,1036,24,2.3
38093,2015,10681,10405,276,2.6
38095,2015,1239,1205,34,2.7
38097,2015,4439,4313,126,2.8
38099,2015,5563,5330,233,4.2
38101,2015,34195,33101,1094,3.2
38103,2015,2167,2080,87,4
38105,2015,28630,27948,682,2.4
39001,2015,10671,9829,842,7.9
39003,2015,47786,45460,2326,4.9
39005,2015,25948,24638,1310,5
39007,2015,44300,41644,2656,6
39009,2015,27881,26138,1743,6.3
39011,2015,24423,23522,901,3.7
39013,2015,31117,29135,1982,6.4
39015,2015,19465,18248,1217,6.3
39017,2015,187236,178609,8627,4.6
39019,2015,13334,12536,798,6
39021,2015,19850,18978,872,4.4
39023,2015,64005,60795,3210,5
39025,2015,102556,97911,4645,4.5
39027,2015,16668,15629,1039,6.2
39029,2015,49330,46425,2905,5.9
39031,2015,15834,14822,1012,6.4
39033,2015,19055,17944,1111,5.8
39035,2015,614586,583171,31415,5.1
39037,2015,26185,25065,1120,4.3
39039,2015,18652,17733,919,4.9
39041,2015,102223,98599,3624,3.5
39043,2015,37316,35242,2074,5.6
39045,2015,74797,71525,3272,4.4
39047,2015,14006,13312,694,5
39049,2015,655089,628175,26914,4.1
39051,2015,22411,21314,1097,4.9
39053,2015,12191,11397,794,6.5
39055,2015,49147,47121,2026,4.1
39057,2015,80288,76770,3518,4.4
39059,2015,19182,17987,1195,6.2
39061,2015,400993,382887,18106,4.5
39063,2015,40709,39212,1497,3.7
39065,2015,14479,13779,700,4.8
39067,2015,7176,6723,453,6.3
39069,2015,13532,12773,759,5.6
39071,2015,16918,15837,1081,6.4
39073,2015,12997,12268,729,5.6
39075,2015,20601,19893,708,3.4
39077,2015,27582,25762,1820,6.6
39079,2015,13034,12050,984,7.5
39081,2015,29355,27168,2187,7.5
39083,2015,31192,29740,1452,4.7
39085,2015,124675,119131,5544,4.4
39087,2015,24872,23407,1465,5.9
39089,2015,86836,82968,3868,4.5
39091,2015,23069,22094,975,4.2
39093,2015,151230,142920,8310,5.5
39095,2015,208517,197405,11112,5.3
39097,2015,20473,19644,829,4
39099,2015,106815,100284,6531,6.1
39101,2015,27741,26316,1425,5.1
39103,2015,95392,91501,3891,4.1
39105,2015,9085,8334,751,8.300000000000001
39107,2015,22976,22220,756,3.3
39109,2015,52335,50025,2310,4.4
39111,2015,5536,4984,552,10
39113,2015,248791,236280,12511,5
39115,2015,6697,6206,491,7.3
39117,2015,16666,15823,843,5.1
39119,2015,38761,36345,2416,6.2
39121,2015,4968,4605,363,7.3
39123,2015,21001,19609,1392,6.6
39125,2015,8894,8466,428,4.8
39127,2015,15808,14772,1036,6.6
39129,2015,25712,24484,1228,4.8
39131,2015,10462,9694,768,7.3
39133,2015,86721,82485,4236,4.9
39135,2015,20960,19946,1014,4.8
39137,2015,18641,17916,725,3.9
39139,2015,53502,50505,2997,5.6
39141,2015,33675,31864,1811,5.4
39143,2015,31320,29806,1514,4.8
39145,2015,29543,27274,2269,7.7
39147,2015,27113,25797,1316,4.9
39149,2015,24050,23012,1038,4.3
39151,2015,186328,176479,9849,5.3
39153,2015,271430,257871,13559,5
39155,2015,91300,85391,5909,6.5
39157,2015,45389,42941,2448,5.4
39159,2015,26992,25952,1040,3.9
39161,2015,14310,13713,597,4.2
39163,2015,5453,5095,358,6.6
39165,2015,112279,107597,4682,4.2
39167,2015,28025,26334,1691,6
39169,2015,59925,57556,2369,4
39171,2015,18989,18147,842,4.4
39173,2015,69503,66522,2981,4.3
39175,2015,12333,11880,453,3.7
40001,2015,8173,7677,496,6.1
40003,2015,3167,3073,94,3
40005,2015,4866,4550,316,6.5
40007,2015,3026,2944,82,2.7
40009,2015,12222,11599,623,5.1
40011,2015,4491,4318,173,3.9
40013,2015,18358,17520,838,4.6
40015,2015,11848,11237,611,5.2
40017,2015,68358,65890,2468,3.6
40019,2015,22579,21552,1027,4.5
40021,2015,19286,18289,997,5.2
40023,2015,5921,5467,454,7.7
40025,2015,1377,1346,31,2.3
40027,2015,138284,133397,4887,3.5
40029,2015,2322,2145,177,7.6
40031,2015,49691,47527,2164,4.4
40033,2015,2864,2745,119,4.2
40035,2015,6267,5964,303,4.8
40037,2015,31370,29812,1558,5
40039,2015,15671,15036,635,4.1
40041,2015,17493,16627,866,5
40043,2015,2498,2408,90,3.6
40045,2015,2393,2296,97,4.1
40047,2015,30112,28925,1187,3.9
40049,2015,12844,12240,604,4.7
40051,2015,26245,25066,1179,4.5
40053,2015,3292,3196,96,2.9
40055,2015,2171,2048,123,5.7
40057,2015,1304,1259,45,3.5
40059,2015,1988,1928,60,3
40061,2015,4484,4128,356,7.9
40063,2015,5740,5310,430,7.5
40065,2015,10884,10442,442,4.1
40067,2015,2682,2529,153,5.7
40069,2015,3974,3715,259,6.5
40071,2015,19215,18122,1093,5.7
40073,2015,8286,8025,261,3.1
40075,2015,4167,3973,194,4.7
40077,2015,3866,3552,314,8.1
40079,2015,19656,18295,1361,6.9
40081,2015,15893,15151,742,4.7
40083,2015,21494,20676,818,3.8
40085,2015,5984,5771,213,3.6
40087,2015,18774,18077,697,3.7
40089,2015,14753,13582,1171,7.9
40091,2015,7092,6479,613,8.6
40093,2015,4302,4161,141,3.3
40095,2015,6790,6419,371,5.5
40097,2015,19422,18582,840,4.3
40099,2015,6772,6486,286,4.2
40101,2015,29608,28086,1522,5.1
40103,2015,5646,5445,201,3.6
40105,2015,4803,4529,274,5.7
40107,2015,4547,4280,267,5.9
40109,2015,375202,360407,14795,3.9
40111,2015,16237,15152,1085,6.7
40113,2015,21242,20122,1120,5.3
40115,2015,14386,13648,738,5.1
40117,2015,7480,7043,437,5.8
40119,2015,38424,37069,1355,3.5
40121,2015,17451,16455,996,5.7
40123,2015,18262,17534,728,4
40125,2015,32772,31296,1476,4.5
40127,2015,4918,4535,383,7.8
40129,2015,1840,1762,78,4.2
40131,2015,44653,42695,1958,4.4
40133,2015,9614,8958,656,6.8
40135,2015,16794,15727,1067,6.4
40137,2015,20297,19081,1216,6
40139,2015,9701,9389,312,3.2
40141,2015,3361,3217,144,4.3
40143,2015,318160,304974,13186,4.1
40145,2015,36282,34755,1527,4.2
40147,2015,24478,23423,1055,4.3
40149,2015,5611,5299,312,5.6
40151,2015,5372,5224,148,2.8
40153,2015,10312,9779,533,5.2
41001,2015,6672,6221,451,6.8
41003,2015,45429,43512,1917,4.2
41005,2015,205165,194653,10512,5.1
41007,2015,18352,17349,1003,5.5
41009,2015,22680,21058,1622,7.2
41011,2015,25948,24019,1929,7.4
41013,2015,9023,8268,755,8.4
41015,2015,8713,7994,719,8.300000000000001
41017,2015,84750,79768,4982,5.9
41019,2015,44369,41041,3328,7.5
41021,2015,809,757,52,6.4
41023,2015,3091,2822,269,8.699999999999999
41025,2015,3304,3067,237,7.2
41027,2015,13526,12888,638,4.7
41029,2015,98038,91386,6652,6.8
41031,2015,9644,8938,706,7.3
41033,2015,33270,30700,2570,7.7
41035,2015,28664,26426,2238,7.8
41037,2015,3436,3173,263,7.7
41039,2015,172524,162496,10028,5.8
41041,2015,20521,19156,1365,6.7
41043,2015,55189,51479,3710,6.7
41045,2015,11955,11195,760,6.4
41047,2015,152615,143470,9145,6
41049,2015,5542,5224,318,5.7
41051,2015,429636,408570,21066,4.9
41053,2015,36582,34524,2058,5.6
41055,2015,888,834,54,6.1
41057,2015,11389,10748,641,5.6
41059,2015,35246,33005,2241,6.4
41061,2015,11702,10982,720,6.2
41063,2015,3243,2990,253,7.8
41065,2015,13023,12294,729,5.6
41067,2015,301627,287469,14158,4.7
41069,2015,692,656,36,5.2
41071,2015,50861,48173,2688,5.3
42001,2015,54927,52623,2304,4.2
42003,2015,646793,614774,32019,5
42005,2015,32988,30800,2188,6.6
42007,2015,85690,80511,5179,6
42009,2015,24096,22637,1459,6.1
42011,2015,212266,201806,10460,4.9
42013,2015,60921,57786,3135,5.1
42015,2015,31330,29478,1852,5.9
42017,2015,337194,321478,15716,4.7
42019,2015,97988,93370,4618,4.7
42021,2015,62258,58182,4076,6.5
42023,2015,2260,2099,161,7.1
42025,2015,31420,29518,1902,6.1
42027,2015,77719,74635,3084,4
42029,2015,276759,266233,10526,3.8
42031,2015,18248,17159,1089,6
42033,2015,36368,33955,2413,6.6
42035,2015,18741,17453,1288,6.9
42037,2015,33695,31794,1901,5.6
42039,2015,40997,38868,2129,5.2
42041,2015,128248,123140,5108,4
42043,2015,140831,134283,6548,4.6
42045,2015,291197,276966,14231,4.9
42047,2015,16312,15508,804,4.9
42049,2015,134589,127206,7383,5.5
42051,2015,58296,53929,4367,7.5
42053,2015,1897,1748,149,7.9
42055,2015,77763,73912,3851,5
42057,2015,7432,6970,462,6.2
42059,2015,18141,17055,1086,6
42061,2015,19645,18268,1377,7
42063,2015,41705,39077,2628,6.3
42065,2015,20947,19670,1277,6.1
42067,2015,11976,11384,592,4.9
42069,2015,106287,100102,6185,5.8
42071,2015,275676,264354,11322,4.1
42073,2015,42067,39413,2654,6.3
42075,2015,69985,66821,3164,4.5
42077,2015,185560,175687,9873,5.3
42079,2015,158581,148361,10220,6.4
42081,2015,60835,57157,3678,6
42083,2015,18956,17806,1150,6.1
42085,2015,52939,50056,2883,5.4
42087,2015,20891,19686,1205,5.8
42089,2015,80673,75473,5200,6.4
42091,2015,440389,422107,18282,4.2
42093,2015,9136,8742,394,4.3
42095,2015,156406,148188,8218,5.3
42097,2015,43379,40738,2641,6.1
42099,2015,24080,23006,1074,4.5
42101,2015,694732,645414,49318,7.1
42103,2015,24936,23308,1628,6.5
42105,2015,7366,6849,517,7
42107,2015,68112,63832,4280,6.3
42109,2015,20041,19102,939,4.7
42111,2015,34425,32077,2348,6.8
42113,2015,3030,2843,187,6.2
42115,2015,21376,20184,1192,5.6
42117,2015,20308,18986,1322,6.5
42119,2015,19286,18424,862,4.5
42121,2015,24429,22981,1448,5.9
42123,2015,19933,18940,993,5
42125,2015,106499,100574,5925,5.6
42127,2015,22245,20951,1294,5.8
42129,2015,182701,172864,9837,5.4
42131,2015,14099,13240,859,6.1
42133,2015,232453,221422,11031,4.7
44001,2015,26164,24781,1383,5.3
44003,2015,91024,86004,5020,5.5
44005,2015,44085,41700,2385,5.4
44007,2015,323908,303363,20545,6.3
44009,2015,69247,65362,3885,5.6
45001,2015,10365,9650,715,6.9
45003,2015,74046,69671,4375,5.9
45005,2015,2753,2441,312,11.3
45007,2015,88613,83814,4799,5.4
45009,2015,5471,4895,576,10.5
45011,2015,8391,7635,756,9
45013,2015,71772,67841,3931,5.5
45015,2015,93640,88479,5161,5.5
45017,2015,6903,6410,493,7.1
45019,2015,198504,188861,9643,4.9
45021,2015,23502,21823,1679,7.1
45023,2015,13477,12346,1131,8.4
45025,2015,21481,20174,1307,6.1
45027,2015,13089,12079,1010,7.7
45029,2015,16747,15577,1170,7
45031,2015,30116,27889,2227,7.4
45033,2015,12695,11599,1096,8.6
45035,2015,72823,68826,3997,5.5
45037,2015,10685,10005,680,6.4
45039,2015,10040,9229,811,8.1
45041,2015,65624,61322,4302,6.6
45043,2015,25277,23145,2132,8.4
45045,2015,243357,231301,12056,5
45047,2015,31316,29329,1987,6.3
45049,2015,8361,7658,703,8.4
45051,2015,137566,127746,9820,7.1
45053,2015,11839,11231,608,5.1
45055,2015,28991,27254,1737,6
45057,2015,36768,34451,2317,6.3
45059,2015,30339,28342,1997,6.6
45061,2015,6469,5923,546,8.4
45063,2015,145615,138552,7063,4.9
45065,2015,3446,3201,245,7.1
45067,2015,12885,11597,1288,10
45069,2015,9664,8690,974,10.1
45071,2015,18929,17921,1008,5.3
45073,2015,34545,32537,2008,5.8
45075,2015,37010,32976,4034,10.9
45077,2015,56157,52909,3248,5.8
45079,2015,199014,187733,11281,5.7
45081,2015,8844,8380,464,5.2
45083,2015,140106,132080,8026,5.7
45085,2015,44461,41413,3048,6.9
45087,2015,11575,10659,916,7.9
45089,2015,12841,11654,1187,9.199999999999999
45091,2015,126886,119912,6974,5.5
46003,2015,1570,1535,35,2.2
46005,2015,9461,9212,249,2.6
46007,2015,1130,1073,57,5
46009,2015,3007,2927,80,2.7
46011,2015,18549,18006,543,2.9
46013,2015,20973,20414,559,2.7
46015,2015,2534,2466,68,2.7
46017,2015,714,664,50,7
46019,2015,5088,4915,173,3.4
46021,2015,848,823,25,2.9
46023,2015,3980,3843,137,3.4
46025,2015,1963,1892,71,3.6
46027,2015,7004,6789,215,3.1
46029,2015,15307,14835,472,3.1
46031,2015,1489,1413,76,5.1
46033,2015,3959,3791,168,4.2
46035,2015,11316,11029,287,2.5
46037,2015,2858,2715,143,5
46039,2015,2307,2193,114,4.9
46041,2015,2291,2028,263,11.5
46043,2015,1672,1631,41,2.5
46045,2015,2218,2163,55,2.5
46047,2015,2971,2839,132,4.4
46049,2015,1119,1089,30,2.7
46051,2015,4701,4562,139,3
46053,2015,2055,1990,65,3.2
46055,2015,1096,1071,25,2.3
46057,2015,3130,3026,104,3.3
46059,2015,1872,1829,43,2.3
46061,2015,1796,1736,60,3.3
46063,2015,779,760,19,2.4
46065,2015,9887,9649,238,2.4
46067,2015,3670,3579,91,2.5
46069,2015,706,686,20,2.8
46071,2015,1325,1268,57,4.3
46073,2015,1125,1099,26,2.3
46075,2015,584,567,17,2.9
46077,2015,2751,2670,81,2.9
46079,2015,6504,6268,236,3.6
46081,2015,12725,12309,416,3.3
46083,2015,30428,29743,685,2.3
46085,2015,1792,1708,84,4.7
46087,2015,3128,3054,74,2.4
46089,2015,1112,1075,37,3.3
46091,2015,2500,2404,96,3.8
46093,2015,13324,12903,421,3.2
46095,2015,797,756,41,5.1
46097,2015,1210,1181,29,2.4
46099,2015,106213,103346,2867,2.7
46101,2015,3940,3806,134,3.4
46102,2015,3583,3172,411,11.5
46103,2015,54315,52602,1713,3.2
46105,2015,1574,1524,50,3.2
46107,2015,1181,1143,38,3.2
46109,2015,4861,4650,211,4.3
46111,2015,1225,1194,31,2.5
46115,2015,3314,3212,102,3.1
46117,2015,1833,1789,44,2.4
46119,2015,869,847,22,2.5
46121,2015,3047,2822,225,7.4
46123,2015,3078,2996,82,2.7
46125,2015,4632,4508,124,2.7
46127,2015,8022,7750,272,3.4
46129,2015,2265,2143,122,5.4
46135,2015,11588,11286,302,2.6
46137,2015,983,933,50,5.1
47001,2015,33167,31233,1934,5.8
47003,2015,19341,18093,1248,6.5
47005,2015,6743,6224,519,7.7
47007,2015,4236,3899,337,8
47009,2015,59324,56249,3075,5.2
47011,2015,49265,46687,2578,5.2
47013,2015,14579,13423,1156,7.9
47015,2015,5838,5499,339,5.8
47017,2015,12143,11136,1007,8.300000000000001
47019,2015,23448,21936,1512,6.4
47021,2015,19798,18838,960,4.8
47023,2015,8198,7716,482,5.9
47025,2015,12533,11625,908,7.2
47027,2015,2989,2724,265,8.9
47029,2015,14357,13241,1116,7.8
47031,2015,24209,22866,1343,5.5
47033,2015,6797,6360,437,6.4
47035,2015,22852,21234,1618,7.1
47037,2015,362895,346987,15908,4.4
47039,2015,4696,4326,370,7.9
47041,2015,7340,6835,505,6.9
47043,2015,24010,22703,1307,5.4
47045,2015,16607,15414,1193,7.2
47047,2015,17809,16707,1102,6.2
47049,2015,6978,6469,509,7.3
47051,2015,19525,18511,1014,5.2
47053,2015,20957,19410,1547,7.4
47055,2015,14502,13778,724,5
47057,2015,9113,8507,606,6.6
47059,2015,30506,28534,1972,6.5
47061,2015,4855,4477,378,7.8
47063,2015,26373,24735,1638,6.2
47065,2015,166750,157881,8869,5.3
47067,2015,2057,1858,199,9.699999999999999
47069,2015,9258,8562,696,7.5
47071,2015,10228,9492,736,7.2
47073,2015,23453,21952,1501,6.4
47075,2015,7603,6966,637,8.4
47077,2015,12233,11256,977,8
47079,2015,13829,12924,905,6.5
47081,2015,10282,9697,585,5.7
47083,2015,3187,2912,275,8.6
47085,2015,8439,7868,571,6.8
47087,2015,4449,4099,350,7.9
47089,2015,23216,21728,1488,6.4
47091,2015,7284,6873,411,5.6
47093,2015,227624,216975,10649,4.7
47095,2015,1964,1796,168,8.6
47097,2015,9564,8717,847,8.9
47099,2015,17660,16493,1167,6.6
47101,2015,4788,4438,350,7.3
47103,2015,15090,14363,727,4.8
47105,2015,21861,20635,1226,5.6
47107,2015,22570,21141,1429,6.3
47109,2015,8729,7987,742,8.5
47111,2015,9927,9400,527,5.3
47113,2015,46372,43639,2733,5.9
47115,2015,11674,10884,790,6.8
47117,2015,14715,13890,825,5.6
47119,2015,42211,40045,2166,5.1
47121,2015,4841,4471,370,7.6
47123,2015,18981,17787,1194,6.3
47125,2015,78323,73759,4564,5.8
47127,2015,3294,3145,149,4.5
47129,2015,7691,7115,576,7.5
47131,2015,12435,11362,1073,8.6
47133,2015,9059,8412,647,7.1
47135,2015,3109,2900,209,6.7
47137,2015,2392,2208,184,7.7
47139,2015,7301,6819,482,6.6
47141,2015,32336,30448,1888,5.8
47143,2015,13047,12082,965,7.4
47145,2015,22505,21049,1456,6.5
47147,2015,33701,32054,1647,4.9
47149,2015,155052,148094,6958,4.5
47151,2015,8053,7302,751,9.300000000000001
47153,2015,5774,5399,375,6.5
47155,2015,49683,46685,2998,6
47157,2015,428547,401006,27541,6.4
47159,2015,8457,7982,475,5.6
47161,2015,5122,4728,394,7.7
47163,2015,68918,64926,3992,5.8
47165,2015,88284,84211,4073,4.6
47167,2015,27398,25456,1942,7.1
47169,2015,3671,3454,217,5.9
47171,2015,7008,6449,559,8
47173,2015,7195,6705,490,6.8
47175,2015,2047,1883,164,8
47177,2015,17743,16743,1000,5.6
47179,2015,57648,54437,3211,5.6
47181,2015,6166,5709,457,7.4
47183,2015,15541,14483,1058,6.8
47185,2015,11375,10685,690,6.1
47187,2015,107210,102908,4302,4
47189,2015,64400,61446,2954,4.6
48001,2015,22848,21952,896,3.9
48003,2015,9302,8979,323,3.5
48005,2015,37400,35313,2087,5.6
48007,2015,10061,9552,509,5.1
48009,2015,4123,3941,182,4.4
48011,2015,976,950,26,2.7
48013,2015,20539,19563,976,4.8
48015,2015,14044,13400,644,4.6
48017,2015,2800,2680,120,4.3
48019,2015,9180,8816,364,4
48021,2015,37544,36089,1455,3.9
48023,2015,1627,1570,57,3.5
48025,2015,10381,9741,640,6.2
48027,2015,136297,129961,6336,4.6
48029,2015,878969,845536,33433,3.8
48031,2015,5768,5588,180,3.1
48033,2015,413,401,12,2.9
48035,2015,8061,7700,361,4.5
48037,2015,39158,37281,1877,4.8
48039,2015,167079,159444,7635,4.6
48041,2015,108623,105030,3593,3.3
48043,2015,3911,3757,154,3.9
48045,2015,595,572,23,3.9
48047,2015,2603,2345,258,9.9
48049,2015,15895,15210,685,4.3
48051,2015,7759,7422,337,4.3
48053,2015,21179,20409,770,3.6
48055,2015,17427,16672,755,4.3
48057,2015,11330,10879,451,4
48059,2015,5732,5488,244,4.3
48061,2015,163095,151508,11587,7.1
48063,2015,5093,4781,312,6.1
48065,2015,3068,2970,98,3.2
48067,2015,12169,11344,825,6.8
48069,2015,3616,3494,122,3.4
48071,2015,17809,16861,948,5.3
48073,2015,20901,19824,1077,5.2
48075,2015,2869,2780,89,3.1
48077,2015,4913,4698,215,4.4
48079,2015,1318,1251,67,5.1
48081,2015,1399,1342,57,4.1
48083,2015,3050,2881,169,5.5
48085,2015,488708,470996,17712,3.6
48087,2015,1270,1224,46,3.6
48089,2015,9908,9518,390,3.9
48091,2015,61901,59633,2268,3.7
48093,2015,5359,5132,227,4.2
48095,2015,1374,1329,45,3.3
48097,2015,19771,19043,728,3.7
48099,2015,24508,23342,1166,4.8
48101,2015,546,507,39,7.1
48103,2015,1837,1732,105,5.7
48105,2015,1901,1787,114,6
48107,2015,2648,2534,114,4.3
48109,2015,1040,997,43,4.1
48111,2015,4008,3921,87,2.2
48113,2015,1262949,1209003,53946,4.3
48115,2015,4773,4557,216,4.5
48117,2015,8797,8520,277,3.1
48119,2015,2593,2476,117,4.5
48121,2015,428582,413370,15212,3.5
48123,2015,10055,9655,400,4
48125,2015,703,671,32,4.6
48127,2015,7162,6831,331,4.6
48129,2015,1593,1527,66,4.1
48131,2015,5239,4816,423,8.1
48133,2015,8041,7660,381,4.7
48135,2015,79785,76087,3698,4.6
48137,2015,865,825,40,4.6
48139,2015,80960,77778,3182,3.9
48141,2015,341643,324011,17632,5.2
48143,2015,20165,19375,790,3.9
48145,2015,6455,6182,273,4.2
48147,2015,15377,14748,629,4.1
48149,2015,12776,12353,423,3.3
48151,2015,1800,1731,69,3.8
48153,2015,2746,2594,152,5.5
48155,2015,551,529,22,4
48157,2015,355917,340780,15137,4.3
48159,2015,4556,4335,221,4.9
48161,2015,7412,7011,401,5.4
48163,2015,9805,9430,375,3.8
48165,2015,9407,9103,304,3.2
48167,2015,157960,150103,7857,5
48169,2015,2131,2053,78,3.7
48171,2015,12646,12283,363,2.9
48173,2015,822,799,23,2.8
48175,2015,3448,3295,153,4.4
48177,2015,9702,9346,356,3.7
48179,2015,9276,8756,520,5.6
48181,2015,60005,57590,2415,4
48183,2015,59290,56357,2933,4.9
48185,2015,11514,10902,612,5.3
48187,2015,72953,70383,2570,3.5
48189,2015,12889,12072,817,6.3
48191,2015,1204,1140,64,5.3
48193,2015,3484,3322,162,4.6
48195,2015,3112,3020,92,3
48197,2015,1621,1542,79,4.9
48199,2015,24994,23586,1408,5.6
48201,2015,2234702,2131167,103535,4.6
48203,2015,31207,29581,1626,5.2
48205,2015,3004,2940,64,2.1
48207,2015,2583,2493,90,3.5
48209,2015,98479,95110,3369,3.4
48211,2015,2302,2230,72,3.1
48213,2015,34373,32706,1667,4.8
48215,2015,330912,304749,26163,7.9
48217,2015,15618,14909,709,4.5
48219,2015,11721,11235,486,4.1
48221,2015,24538,23434,1104,4.5
48223,2015,17015,16301,714,4.2
48225,2015,9938,9496,442,4.4
48227,2015,13358,12744,614,4.6
48229,2015,1281,1209,72,5.6
48231,2015,38913,37077,1836,4.7
48233,2015,9799,9368,431,4.4
48235,2015,799,770,29,3.6
48237,2015,4079,3907,172,4.2
48239,2015,7369,7093,276,3.7
48241,2015,13879,12844,1035,7.5
48243,2015,1080,1045,35,3.2
48245,2015,107975,100467,7508,7
48247,2015,2028,1882,146,7.2
48249,2015,19221,17706,1515,7.9
48251,2015,74300,71044,3256,4.4
48253,2015,5669,5358,311,5.5
48255,2015,6427,6156,271,4.2
48257,2015,55070,52832,2238,4.1
48259,2015,19164,18536,628,3.3
48261,2015,283,274,9,3.2
48263,2015,498,485,13,2.6
48265,2015,21183,20406,777,3.7
48267,2015,2000,1927,73,3.7
48269,2015,200,193,7,3.5
48271,2015,1185,1110,75,6.3
48273,2015,14398,13550,848,5.9
48275,2015,1682,1619,63,3.7
48277,2015,22186,21128,1058,4.8
48279,2015,5509,5018,491,8.9
48281,2015,9057,8660,397,4.4
48283,2015,4269,4092,177,4.1
48285,2015,8807,8474,333,3.8
48287,2015,9303,8973,330,3.5
48289,2015,6933,6564,369,5.3
48291,2015,30951,28818,2133,6.9
48293,2015,8580,8151,429,5
48295,2015,1724,1657,67,3.9
48297,2015,5891,5655,236,4
48299,2015,8150,7805,345,4.2
48301,2015,77,73,4,5.2
48303,2015,149605,144524,5081,3.4
48305,2015,2763,2652,111,4
48307,2015,3923,3735,188,4.8
48309,2015,112586,108012,4574,4.1
48311,2015,969,949,20,2.1
48313,2015,5118,4898,220,4.3
48315,2015,4414,4128,286,6.5
48317,2015,2585,2494,91,3.5
48319,2015,1804,1735,69,3.8
48321,2015,17179,16023,1156,6.7
48323,2015,23643,21129,2514,10.6
48325,2015,20425,19534,891,4.4
48327,2015,857,813,44,5.1
48329,2015,88395,85342,3053,3.5
48331,2015,10122,9593,529,5.2
48333,2015,1990,1917,73,3.7
48335,2015,2744,2590,154,5.6
48337,2015,9706,9295,411,4.2
48339,2015,258253,247310,10943,4.2
48341,2015,11113,10767,346,3.1
48343,2015,5314,4848,466,8.800000000000001
48345,2015,492,475,17,3.5
48347,2015,28134,26816,1318,4.7
48349,2015,22891,21930,961,4.2
48351,2015,5368,4965,403,7.5
48353,2015,6914,6635,279,4
48355,2015,165837,157657,8180,4.9
48357,2015,5273,5049,224,4.2
48359,2015,914,887,27,3
48361,2015,37188,34762,2426,6.5
48363,2015,13168,12484,684,5.2
48365,2015,11572,10968,604,5.2
48367,2015,59575,57105,2470,4.1
48369,2015,4969,4852,117,2.4
48371,2015,6867,6513,354,5.2
48373,2015,17042,16012,1030,6
48375,2015,56262,54392,1870,3.3
48377,2015,3115,2784,331,10.6
48379,2015,5412,5166,246,4.5
48381,2015,69101,67104,1997,2.9
48383,2015,1929,1842,87,4.5
48385,2015,1064,1009,55,5.2
48387,2015,4910,4601,309,6.3
48389,2015,5679,5407,272,4.8
48391,2015,3307,3131,176,5.3
48393,2015,456,438,18,3.9
48395,2015,7249,6904,345,4.8
48397,2015,44906,43224,1682,3.7
48399,2015,4671,4498,173,3.7
48401,2015,22847,21762,1085,4.7
48403,2015,3501,3176,325,9.300000000000001
48405,2015,2799,2546,253,9
48407,2015,11292,10659,633,5.6
48409,2015,30235,28269,1966,6.5
48411,2015,2246,2164,82,3.7
48413,2015,1501,1422,79,5.3
48415,2015,8169,7831,338,4.1
48417,2015,2083,2024,59,2.8
48419,2015,11380,10782,598,5.3
48421,2015,1421,1382,39,2.7
48423,2015,103748,99116,4632,4.5
48425,2015,4111,3905,206,5
48427,2015,25879,22399,3480,13.4
48429,2015,4107,3936,171,4.2
48431,2015,747,722,25,3.3
48433,2015,663,634,29,4.4
48435,2015,1719,1615,104,6.1
48437,2015,2733,2603,130,4.8
48439,2015,991642,950457,41185,4.2
48441,2015,63362,61042,2320,3.7
48443,2015,435,414,21,4.8
48445,2015,5403,5151,252,4.7
48447,2015,781,756,25,3.2
48449,2015,12736,12004,732,5.7
48451,2015,54556,52322,2234,4.1
48453,2015,655804,634333,21471,3.3
48455,2015,5482,5160,322,5.9
48457,2015,7367,6852,515,7
48459,2015,17978,17036,942,5.2
48461,2015,1785,1715,70,3.9
48463,2015,11683,11095,588,5
48465,2015,19573,18401,1172,6
48467,2015,24214,23128,1086,4.5
48469,2015,45340,43445,1895,4.2
48471,2015,22979,21820,1159,5
48473,2015,21664,20626,1038,4.8
48475,2015,5914,5661,253,4.3
48477,2015,15361,14631,730,4.8
48479,2015,111798,106521,5277,4.7
48481,2015,21233,20298,935,4.4
48483,2015,2821,2712,109,3.9
48485,2015,55334,52967,2367,4.3
48487,2015,5110,4864,246,4.8
48489,2015,6747,5869,878,13
48491,2015,264046,254946,9100,3.4
48493,2015,22977,22107,870,3.8
48495,2015,3104,2927,177,5.7
48497,2015,28677,27350,1327,4.6
48499,2015,16764,15876,888,5.3
48501,2015,4047,3895,152,3.8
48503,2015,8470,8110,360,4.3
48505,2015,6191,5719,472,7.6
48507,2015,3807,3382,425,11.2
49001,2015,3115,2997,118,3.8
49003,2015,23965,23077,888,3.7
49005,2015,60008,58164,1844,3.1
49007,2015,8706,8209,497,5.7
49009,2015,467,445,22,4.7
49011,2015,159878,154456,5422,3.4
49013,2015,8805,8140,665,7.6
49015,2015,4400,4133,267,6.1
49017,2015,2754,2508,246,8.9
49019,2015,5609,5267,342,6.1
49021,2015,20321,19415,906,4.5
49023,2015,4935,4739,196,4
49025,2015,3623,3463,160,4.4
49027,2015,6121,5906,215,3.5
49029,2015,4925,4771,154,3.1
49031,2015,465,435,30,6.5
49033,2015,1045,1007,38,3.6
49035,2015,585134,565279,19855,3.4
49037,2015,5715,5263,452,7.9
49039,2015,11412,10939,473,4.1
49041,2015,9506,9081,425,4.5
49043,2015,23057,22292,765,3.3
49045,2015,29520,28294,1226,4.2
49047,2015,15298,14254,1044,6.8
49049,2015,265907,257217,8690,3.3
49051,2015,13251,12784,467,3.5
49053,2015,63625,61023,2602,4.1
49055,2015,1413,1285,128,9.1
49057,2015,117158,112346,4812,4.1
50001,2015,20693,19978,715,3.5
50003,2015,18573,17793,780,4.2
50005,2015,15079,14380,699,4.6
50007,2015,94862,92292,2570,2.7
50009,2015,2756,2598,158,5.7
50011,2015,27296,26326,970,3.6
50013,2015,3935,3778,157,4
50015,2015,13776,13139,637,4.6
50017,2015,15893,15350,543,3.4
50019,2015,13591,12837,754,5.5
50021,2015,31271,29946,1325,4.2
50023,2015,34057,32872,1185,3.5
50025,2015,23453,22620,833,3.6
50027,2015,29464,28521,943,3.2
51001,2015,15877,15011,866,5.5
51003,2015,53910,51806,2104,3.9
51005,2015,7048,6691,357,5.1
51007,2015,6190,5913,277,4.5
51009,2015,15277,14548,729,4.8
51011,2015,7037,6693,344,4.9
51013,2015,144273,140209,4064,2.8
51015,2015,36639,35136,1503,4.1
51017,2015,2536,2433,103,4.1
51019,2015,38224,36528,1696,4.4
51021,2015,2781,2623,158,5.7
51023,2015,17387,16658,729,4.2
51025,2015,6331,5900,431,6.8
51027,2015,7276,6486,790,10.9
51029,2015,6292,5919,373,5.9
51031,2015,26222,24981,1241,4.7
51033,2015,14731,13980,751,5.1
51035,2015,13048,12350,698,5.3
51036,2015,3716,3518,198,5.3
51037,2015,5250,4951,299,5.7
51041,2015,177940,170275,7665,4.3
51043,2015,7430,7134,296,4
51045,2015,2380,2249,131,5.5
51047,2015,23101,22097,1004,4.3
51049,2015,4554,4320,234,5.1
51051,2015,4911,4415,496,10.1
51053,2015,13309,12588,721,5.4
51057,2015,5511,5214,297,5.4
51059,2015,613577,591667,21910,3.6
51061,2015,35723,34313,1410,3.9
51063,2015,8291,7961,330,4
51065,2015,13158,12663,495,3.8
51067,2015,26442,25207,1235,4.7
51069,2015,44609,42838,1771,4
51071,2015,7942,7531,411,5.2
51073,2015,19089,18311,778,4.1
51075,2015,10615,10171,444,4.2
51077,2015,7045,6628,417,5.9
51079,2015,9846,9480,366,3.7
51081,2015,4172,3947,225,5.4
51083,2015,15197,14231,966,6.4
51085,2015,56229,54048,2181,3.9
51087,2015,176904,169302,7602,4.3
51089,2015,22351,20918,1433,6.4
51091,2015,1339,1292,47,3.5
51093,2015,18799,17940,859,4.6
51095,2015,34289,32803,1486,4.3
51097,2015,3630,3455,175,4.8
51099,2015,12052,11478,574,4.8
51101,2015,8703,8335,368,4.2
51103,2015,5130,4791,339,6.6
51105,2015,8572,7952,620,7.2
51107,2015,200040,192906,7134,3.6
51109,2015,18789,17992,797,4.2
51111,2015,5284,5014,270,5.1
51113,2015,7223,6977,246,3.4
51115,2015,4073,3901,172,4.2
51117,2015,12513,11747,766,6.1
51119,2015,4980,4769,211,4.2
51121,2015,49719,47570,2149,4.3
51125,2015,7266,6970,296,4.1
51127,2015,11212,10784,428,3.8
51131,2015,6097,5724,373,6.1
51133,2015,5463,5129,334,6.1
51135,2015,7129,6806,323,4.5
51137,2015,16052,15314,738,4.6
51139,2015,11642,10840,802,6.9
51141,2015,7638,7224,414,5.4
51143,2015,30067,28470,1597,5.3
51145,2015,13387,12854,533,4
51147,2015,10056,9427,629,6.3
51149,2015,14871,14066,805,5.4
51153,2015,231335,221769,9566,4.1
51155,2015,16307,15482,825,5.1
51157,2015,3734,3579,155,4.2
51159,2015,3899,3721,178,4.6
51161,2015,49067,47139,1928,3.9
51163,2015,10321,9835,486,4.7
51165,2015,40106,38455,1651,4.1
51167,2015,11422,10672,750,6.6
51169,2015,9499,9009,490,5.2
51171,2015,21032,20134,898,4.3
51173,2015,13459,12581,878,6.5
51175,2015,9196,8827,369,4
51177,2015,63796,60836,2960,4.6
51179,2015,66644,63671,2973,4.5
51181,2015,3716,3528,188,5.1
51183,2015,4072,3793,279,6.9
51185,2015,16610,15381,1229,7.4
51187,2015,19617,18683,934,4.8
51191,2015,26976,25681,1295,4.8
51193,2015,8919,8438,481,5.4
51195,2015,13782,12640,1142,8.300000000000001
51197,2015,13641,12900,741,5.4
51199,2015,31988,30616,1372,4.3
51510,2015,94147,91049,3098,3.3
51520,2015,7512,7109,403,5.4
51530,2015,3293,3126,167,5.1
51540,2015,24643,23733,910,3.7
51550,2015,116301,111019,5282,4.5
51570,2015,8665,8256,409,4.7
51580,2015,2418,2272,146,6
51590,2015,19114,17734,1380,7.2
51595,2015,2244,2088,156,7
51600,2015,12798,12350,448,3.5
51610,2015,7843,7604,239,3
51620,2015,3608,3366,242,6.7
51630,2015,13366,12652,714,5.3
51640,2015,2945,2784,161,5.5
51650,2015,64253,60393,3860,6
51660,2015,23881,22613,1268,5.3
51670,2015,9619,8890,729,7.6
51678,2015,2252,2098,154,6.8
51680,2015,35625,33630,1995,5.6
51683,2015,21592,20695,897,4.2
51685,2015,8333,7984,349,4.2
51690,2015,5356,4885,471,8.800000000000001
51700,2015,88801,83967,4834,5.4
51710,2015,110513,104340,6173,5.6
51720,2015,1732,1612,120,6.9
51730,2015,13501,12262,1239,9.199999999999999
51735,2015,6200,5960,240,3.9
51740,2015,44248,41490,2758,6.2
51750,2015,8291,7822,469,5.7
51760,2015,112693,106812,5881,5.2
51770,2015,48900,46506,2394,4.9
51775,2015,12764,12200,564,4.4
51790,2015,11809,11295,514,4.4
51800,2015,42287,40188,2099,5
51810,2015,228751,218937,9814,4.3
51820,2015,10009,9530,479,4.8
51830,2015,6657,6235,422,6.3
51840,2015,14198,13575,623,4.4
53001,2015,8604,7997,607,7.1
53003,2015,9658,9186,472,4.9
53005,2015,91584,85356,6228,6.8
53007,2015,42552,40136,2416,5.7
53009,2015,26762,24553,2209,8.300000000000001
53011,2015,213981,199931,14050,6.6
53013,2015,1690,1578,112,6.6
53015,2015,44050,40584,3466,7.9
53017,2015,19740,18452,1288,6.5
53019,2015,2473,2217,256,10.4
53021,2015,38914,35903,3011,7.7
53023,2015,928,870,58,6.3
53025,2015,44630,41318,3312,7.4
53027,2015,26888,24406,2482,9.199999999999999
53029,2015,31706,29732,1974,6.2
53031,2015,11180,10368,812,7.3
53033,2015,1184240,1134979,49261,4.2
53035,2015,115129,108612,6517,5.7
53037,2015,20808,19490,1318,6.3
53039,2015,9441,8751,690,7.3
53041,2015,31184,28510,2674,8.6
53043,2015,4867,4577,290,6
53045,2015,22982,21149,1833,8
53047,2015,21199,19701,1498,7.1
53049,2015,8088,7347,741,9.199999999999999
53051,2015,4596,4144,452,9.800000000000001
53053,2015,391623,365985,25638,6.5
53055,2015,7705,7326,379,4.9
53057,2015,56605,52697,3908,6.9
53059,2015,4940,4567,373,7.6
53061,2015,403721,385403,18318,4.5
53063,2015,227485,212364,15121,6.6
53065,2015,17425,15842,1583,9.1
53067,2015,125511,117879,7632,6.1
53069,2015,1291,1173,118,9.1
53071,2015,27997,26322,1675,6
53073,2015,104082,97766,6316,6.1
53075,2015,22706,21581,1125,5
53077,2015,121609,111601,10008,8.199999999999999
54001,2015,6893,6383,510,7.4
54003,2015,53859,51219,2640,4.9
54005,2015,8177,7382,795,9.699999999999999
54007,2015,5456,4969,487,8.9
54009,2015,10077,9338,739,7.3
54011,2015,41242,39000,2242,5.4
54013,2015,2759,2415,344,12.5
54015,2015,3268,2903,365,11.2
54017,2015,3638,3437,201,5.5
54019,2015,16260,14865,1395,8.6
54021,2015,2702,2491,211,7.8
54023,2015,5758,5322,436,7.6
54025,2015,15345,14339,1006,6.6
54027,2015,9615,9077,538,5.6
54029,2015,12981,11970,1011,7.8
54031,2015,5463,5055,408,7.5
54033,2015,31813,29808,2005,6.3
54035,2015,11898,11040,858,7.2
54037,2015,27724,26585,1139,4.1
54039,2015,86120,80958,5162,6
54041,2015,6970,6396,574,8.199999999999999
54043,2015,7348,6632,716,9.699999999999999
54045,2015,11483,10195,1288,11.2
54047,2015,5337,4657,680,12.7
54049,2015,25990,24209,1781,6.9
54051,2015,14035,12847,1188,8.5
54053,2015,9956,9108,848,8.5
54055,2015,21943,20351,1592,7.3
54057,2015,11608,10757,851,7.3
54059,2015,7221,6270,951,13.2
54061,2015,50405,48032,2373,4.7
54063,2015,5743,5423,320,5.6
54065,2015,7464,7055,409,5.5
54067,2015,9924,9026,898,9
54069,2015,20636,19479,1157,5.6
54071,2015,3570,3404,166,4.6
54073,2015,2981,2728,253,8.5
54075,2015,3587,3295,292,8.1
54077,2015,14621,13709,912,6.2
54079,2015,25504,24077,1427,5.6
54081,2015,30309,28072,2237,7.4
54083,2015,11885,11052,833,7
54085,2015,4489,4175,314,7
54087,2015,5216,4617,599,11.5
54089,2015,4515,4197,318,7
54091,2015,7731,7268,463,6
54093,2015,3419,3210,209,6.1
54095,2015,3652,3310,342,9.4
54097,2015,9650,8875,775,8
54099,2015,15552,14446,1106,7.1
54101,2015,3468,3206,262,7.6
54103,2015,7153,6437,716,10
54105,2015,2254,2021,233,10.3
54107,2015,37027,34697,2330,6.3
54109,2015,7738,6992,746,9.6
55001,2015,8329,7724,605,7.3
55003,2015,7923,7428,495,6.2
55005,2015,24460,23239,1221,5
55007,2015,7530,6903,627,8.300000000000001
55009,2015,139228,133561,5667,4.1
55011,2015,6534,6214,320,4.9
55013,2015,7273,6763,510,7
55015,2015,27458,26479,979,3.6
55017,2015,33149,31586,1563,4.7
55019,2015,17427,16664,763,4.4
55021,2015,31342,29972,1370,4.4
55023,2015,7905,7442,463,5.9
55025,2015,310737,300846,9891,3.2
55027,2015,47540,45447,2093,4.4
55029,2015,15487,14454,1033,6.7
55031,2015,23351,22196,1155,4.9
55033,2015,23773,22705,1068,4.5
55035,2015,58155,55941,2214,3.8
55037,2015,2213,2064,149,6.7
55039,2015,57030,54706,2324,4.1
55041,2015,3997,3698,299,7.5
55043,2015,28162,26928,1234,4.4
55045,2015,21091,20287,804,3.8
55047,2015,9993,9452,541,5.4
55049,2015,13692,13111,581,4.2
55051,2015,2622,2391,231,8.800000000000001
55053,2015,10346,9853,493,4.8
55055,2015,45648,43717,1931,4.2
55057,2015,13510,12816,694,5.1
55059,2015,87338,82888,4450,5.1
55061,2015,10893,10447,446,4.1
55063,2015,66614,64047,2567,3.9
55065,2015,9746,9389,357,3.7
55067,2015,9474,8898,576,6.1
55069,2015,15257,14495,762,5
55071,2015,41897,39796,2101,5
55073,2015,73453,70499,2954,4
55075,2015,20747,19542,1205,5.8
55077,2015,7497,7038,459,6.1
55078,2015,1604,1449,155,9.699999999999999
55079,2015,477008,449615,27393,5.7
55081,2015,22834,21818,1016,4.4
55083,2015,20343,19293,1050,5.2
55085,2015,18637,17560,1077,5.8
55087,2015,101952,97913,4039,4
55089,2015,48235,46458,1777,3.7
55091,2015,4107,3935,172,4.2
55093,2015,24132,23184,948,3.9
55095,2015,24606,23418,1188,4.8
55097,2015,39583,37767,1816,4.6
55099,2015,6851,6546,305,4.5
55101,2015,99343,93773,5570,5.6
55103,2015,9294,8904,390,4.2
55105,2015,83339,79019,4320,5.2
55107,2015,6997,6614,383,5.5
55109,2015,48808,46939,1869,3.8
55111,2015,35302,33853,1449,4.1
55113,2015,7815,7197,618,7.9
55115,2015,21285,20249,1036,4.9
55117,2015,61248,58938,2310,3.8
55119,2015,10700,10228,472,4.4
55121,2015,16615,15965,650,3.9
55123,2015,15493,14857,636,4.1
55125,2015,10001,9300,701,7
55127,2015,56982,54341,2641,4.6
55129,2015,7957,7530,427,5.4
55131,2015,76060,73211,2849,3.7
55133,2015,221383,212983,8400,3.8
55135,2015,27035,25783,1252,4.6
55137,2015,11487,10765,722,6.3
55139,2015,91447,87574,3873,4.2
55141,2015,34423,32526,1897,5.5
56001,2015,20635,19979,656,3.2
56003,2015,5558,5310,248,4.5
56005,2015,25810,24784,1026,4
56007,2015,8437,8120,317,3.8
56009,2015,8313,8006,307,3.7
56011,2015,3708,3577,131,3.5
56013,2015,20247,19114,1133,5.6
56015,2015,7079,6844,235,3.3
56017,2015,2400,2299,101,4.2
56019,2015,4202,3995,207,4.9
56021,2015,48621,46677,1944,4
56023,2015,8413,8013,400,4.8
56025,2015,42842,40723,2119,4.9
56027,2015,1327,1287,40,3
56029,2015,15767,15083,684,4.3
56031,2015,4911,4717,194,4
56033,2015,15930,15249,681,4.3
56035,2015,4571,4330,241,5.3
56037,2015,22745,21664,1081,4.8
56039,2015,14694,14119,575,3.9
56041,2015,9675,9186,489,5.1
56043,2015,4267,4087,180,4.2
56045,2015,3961,3825,136,3.4
72001,2015,4385,3608,777,17.7
72003,2015,11826,10172,1654,14
72005,2015,14768,12694,2074,14
72007,2015,6828,5830,998,14.6
72009,2015,6648,5678,970,14.6
72011,2015,8857,7702,1155,13
72013,2015,23927,20600,3327,13.9
72015,2015,5191,4213,978,18.8
72017,2015,5908,5010,898,15.2
72019,2015,7422,6439,983,13.2
72021,2015,67355,61093,6262,9.300000000000001
72023,2015,14132,12404,1728,12.2
72025,2015,48445,43426,5019,10.4
72027,2015,9429,8217,1212,12.9
72029,2015,16270,14358,1912,11.8
72031,2015,62770,57222,5548,8.800000000000001
72033,2015,8048,7207,841,10.4
72035,2015,16237,14493,1744,10.7
72037,2015,3866,3331,535,13.8
72039,2015,3915,3235,680,17.4
72041,2015,15546,14001,1545,9.9
72043,2015,11020,8939,2081,18.9
72045,2015,5155,4370,785,15.2
72047,2015,9419,8152,1267,13.5
72049,2015,844,813,31,3.7
72051,2015,12803,11802,1001,7.8
72053,2015,11552,9848,1704,14.8
72054,2015,3400,2892,508,14.9
72055,2015,4204,3380,824,19.6
72057,2015,12242,10123,2119,17.3
72059,2015,5319,4284,1035,19.5
72061,2015,37218,35051,2167,5.8
72063,2015,17292,15789,1503,8.699999999999999
72065,2015,13064,11024,2040,15.6
72067,2015,5583,4934,649,11.6
72069,2015,17646,15044,2602,14.7
72071,2015,12313,10760,1553,12.6
72073,2015,4158,3543,615,14.8
72075,2015,15758,13369,2389,15.2
72077,2015,12478,10743,1735,13.9
72079,2015,5609,4603,1006,17.9
72081,2015,7358,5860,1498,20.4
72083,2015,2887,2401,486,16.8
72085,2015,11350,9757,1593,14
72087,2015,8793,7760,1033,11.7
72089,2015,6455,5451,1004,15.6
72091,2015,11674,10291,1383,11.8
72093,2015,1855,1549,306,16.5
72095,2015,3038,2478,560,18.4
72097,2015,23411,20248,3163,13.5
72099,2015,10641,8981,1660,15.6
72101,2015,8137,6992,1145,14.1
72103,2015,8088,7023,1065,13.2
72105,2015,7307,6308,999,13.7
72107,2015,5254,4396,858,16.3
72109,2015,4847,3837,1010,20.8
72111,2015,6247,5155,1092,17.5
72113,2015,48408,41686,6722,13.9
72115,2015,6038,5025,1013,16.8
72117,2015,4639,3874,765,16.5
72119,2015,17061,15297,1764,10.3
72121,2015,6366,5425,941,14.8
72123,2015,7897,5992,1905,24.1
72125,2015,10330,8872,1458,14.1
72127,2015,135762,125441,10321,7.6
72129,2015,11979,10410,1569,13.1
72131,2015,10677,8555,2122,19.9
72133,2015,9533,7791,1742,18.3
72135,2015,26336,24140,2196,8.300000000000001
72137,2015,30030,27316,2714,9
72139,2015,27212,25308,1904,7
72141,2015,6925,5817,1108,16
72143,2015,9872,8719,1153,11.7
72145,2015,13820,11921,1899,13.7
72147,2015,3194,2832,362,11.3
72149,2015,7802,6262,1540,19.7
72151,2015,9198,7593,1605,17.4
72153,2015,10748,8717,2031,18.9
,,,,,
,,,,,
,,,,,
1001,2016,26031,24709,1322,5.1
1003,2016,90895,86060,4835,5.3
1005,2016,8436,7736,700,8.300000000000001
1007,2016,8644,8088,556,6.4
1009,2016,24684,23358,1326,5.4
1011,2016,4844,4514,330,6.8
1013,2016,9229,8593,636,6.9
1015,2016,46013,43016,2997,6.5
1017,2016,15043,14225,818,5.4
1019,2016,11382,10808,574,5
1021,2016,19266,18213,1053,5.5
1023,2016,4344,3976,368,8.5
1025,2016,7985,7121,864,10.8
1027,2016,5648,5314,334,5.9
1029,2016,5810,5464,346,6
1031,2016,20684,19474,1210,5.8
1033,2016,23548,21918,1630,6.9
1035,2016,4567,4184,383,8.4
1037,2016,4399,4137,262,6
1039,2016,15556,14509,1047,6.7
1041,2016,6480,6101,379,5.8
1043,2016,38064,36179,1885,5
1045,2016,20043,18888,1155,5.8
1047,2016,15480,14059,1421,9.199999999999999
1049,2016,29355,27582,1773,6
1051,2016,37384,35613,1771,4.7
1053,2016,14613,13646,967,6.6
1055,2016,43451,40892,2559,5.9
1057,2016,6623,6178,445,6.7
1059,2016,13924,13108,816,5.9
1061,2016,10853,10226,627,5.8
1063,2016,2884,2598,286,9.9
1065,2016,6006,5548,458,7.6
1067,2016,6749,6311,438,6.5
1069,2016,44735,42156,2579,5.8
1071,2016,23681,22193,1488,6.3
1073,2016,312478,294630,17848,5.7
1075,2016,5713,5392,321,5.6
1077,2016,42703,39998,2705,6.3
1079,2016,13775,12828,947,6.9
1081,2016,72653,68867,3786,5.2
1083,2016,40853,38720,2133,5.2
1085,2016,3815,3414,401,10.5
1087,2016,7900,7301,599,7.6
1089,2016,174275,165388,8887,5.1
1091,2016,7703,7155,548,7.1
1093,2016,12547,11720,827,6.6
1095,2016,41754,39535,2219,5.3
1097,2016,188542,176094,12448,6.6
1099,2016,7344,6681,663,9
1101,2016,106190,100202,5988,5.6
1103,2016,55092,52056,3036,5.5
1105,2016,3481,3123,358,10.3
1107,2016,7798,7265,533,6.8
1109,2016,15009,14038,971,6.5
1111,2016,9467,8941,526,5.6
1113,2016,23627,22322,1305,5.5
1115,2016,39241,37217,2024,5.2
1117,2016,110035,105324,4711,4.3
1119,2016,5131,4738,393,7.7
1121,2016,34955,32660,2295,6.6
1123,2016,18656,17620,1036,5.6
1125,2016,99659,94059,5600,5.6
1127,2016,25669,23767,1902,7.4
1129,2016,6769,6188,581,8.6
1131,2016,2828,2422,406,14.4
1133,2016,9571,8895,676,7.1
2013,2016,2583,2514,69,2.7
2016,2016,3974,3842,132,3.3
2020,2016,155274,146720,8554,5.5
2050,2016,7237,6207,1030,14.2
2060,2016,413,384,29,7
2068,2016,1093,994,99,9.1
2070,2016,2075,1875,200,9.6
2090,2016,46394,43667,2727,5.9
2100,2016,1073,963,110,10.3
2105,2016,1202,1060,142,11.8
2110,2016,17316,16540,776,4.5
2122,2016,27127,24818,2309,8.5
2130,2016,7015,6558,457,6.5
2150,2016,6409,6079,330,5.1
2158,2016,2721,2133,588,21.6
2164,2016,655,573,82,12.5
2170,2016,47351,43455,3896,8.199999999999999
2180,2016,4079,3561,518,12.7
2185,2016,3948,3681,267,6.8
2188,2016,2960,2487,473,16
2195,2016,1449,1318,131,9
2198,2016,2765,2428,337,12.2
2220,2016,4366,4164,202,4.6
2230,2016,805,715,90,11.2
2240,2016,2993,2671,322,10.8
2261,2016,4804,4391,413,8.6
2275,2016,1053,974,79,7.5
2282,2016,243,223,20,8.199999999999999
2290,2016,2419,1987,432,17.9
4001,2016,20284,17966,2318,11.4
4003,2016,49528,46452,3076,6.2
4005,2016,74081,69639,4442,6
4007,2016,20965,19455,1510,7.2
4009,2016,14352,13389,963,6.7
4011,2016,3894,3600,294,7.6
4012,2016,8459,7949,510,6
4013,2016,2077868,1983062,94806,4.6
4015,2016,80396,75095,5301,6.6
4017,2016,41267,37871,3396,8.199999999999999
4019,2016,469004,445827,23177,4.9
4021,2016,163726,154681,9045,5.5
4023,2016,19161,17244,1917,10
4025,2016,99398,94517,4881,4.9
4027,2016,93912,76271,17641,18.8
5001,2016,9255,8940,315,3.4
5003,2016,7940,7454,486,6.1
5005,2016,16077,15387,690,4.3
5007,2016,127720,124007,3713,2.9
5009,2016,15904,15321,583,3.7
5011,2016,4477,4252,225,5
5013,2016,2389,2279,110,4.6
5015,2016,12850,12393,457,3.6
5017,2016,3577,3342,235,6.6
5019,2016,9557,9144,413,4.3
5021,2016,6028,5688,340,5.6
5023,2016,9469,8907,562,5.9
5025,2016,3338,3188,150,4.5
5027,2016,9281,8753,528,5.7
5029,2016,8439,7958,481,5.7
5031,2016,52147,50456,1691,3.2
5033,2016,26907,25860,1047,3.9
5035,2016,21573,20600,973,4.5
5037,2016,7871,7523,348,4.4
5039,2016,2977,2833,144,4.8
5041,2016,5437,5141,296,5.4
5043,2016,7977,7525,452,5.7
5045,2016,60456,58164,2292,3.8
5047,2016,7353,7057,296,4
5049,2016,4660,4458,202,4.3
5051,2016,40021,38301,1720,4.3
5053,2016,8261,7964,297,3.6
5055,2016,19774,18927,847,4.3
5057,2016,9988,9613,375,3.8
5059,2016,14092,13539,553,3.9
5061,2016,5970,5775,195,3.3
5063,2016,15986,15195,791,4.9
5065,2016,4959,4681,278,5.6
5067,2016,6048,5671,377,6.2
5069,2016,28278,26695,1583,5.6
5071,2016,10516,10018,498,4.7
5073,2016,2578,2428,150,5.8
5075,2016,6906,6607,299,4.3
5077,2016,3087,2942,145,4.7
5079,2016,4088,3891,197,4.8
5081,2016,5584,5323,261,4.7
5083,2016,9114,8696,418,4.6
5085,2016,33335,32226,1109,3.3
5087,2016,7274,7041,233,3.2
5089,2016,6511,6251,260,4
5091,2016,19837,19007,830,4.2
5093,2016,18039,16817,1222,6.8
5095,2016,2876,2738,138,4.8
5097,2016,3123,2963,160,5.1
5099,2016,3638,3504,134,3.7
5101,2016,3407,3274,133,3.9
5103,2016,9864,9369,495,5
5105,2016,4161,3962,199,4.8
5107,2016,6645,6254,391,5.9
5109,2016,4214,4035,179,4.2
5111,2016,10075,9645,430,4.3
5113,2016,8168,7770,398,4.9
5115,2016,29234,27893,1341,4.6
5117,2016,3644,3505,139,3.8
5119,2016,186810,180191,6619,3.5
5121,2016,6513,6213,300,4.6
5123,2016,8826,8368,458,5.2
5125,2016,56768,54998,1770,3.1
5127,2016,4456,4292,164,3.7
5129,2016,2984,2848,136,4.6
5131,2016,57509,55370,2139,3.7
5133,2016,5685,5410,275,4.8
5135,2016,6041,5713,328,5.4
5137,2016,4733,4490,243,5.1
5139,2016,16346,15455,891,5.5
5141,2016,6092,5674,418,6.9
5143,2016,118196,114945,3251,2.8
5145,2016,33984,32217,1767,5.2
5147,2016,2964,2802,162,5.5
5149,2016,8672,8285,387,4.5
6001,2016,831718,796037,35681,4.3
6003,2016,553,518,35,6.3
6005,2016,14522,13658,864,5.9
6007,2016,101627,94909,6718,6.6
6009,2016,20794,19615,1179,5.7
6011,2016,10901,9205,1696,15.6
6013,2016,553145,528400,24745,4.5
6015,2016,9753,9019,734,7.5
6017,2016,88810,84248,4562,5.1
6019,2016,444599,402365,42234,9.5
6021,2016,12945,11867,1078,8.300000000000001
6023,2016,62413,59337,3076,4.9
6025,2016,75141,56997,18144,24.1
6027,2016,8857,8389,468,5.3
6029,2016,387978,347694,40284,10.4
6031,2016,57141,51446,5695,10
6033,2016,29061,27108,1953,6.7
6035,2016,10360,9642,718,6.9
6037,2016,5030508,4765899,264609,5.3
6039,2016,61032,55393,5639,9.199999999999999
6041,2016,139619,135040,4579,3.3
6043,2016,7567,7048,519,6.9
6045,2016,39609,37521,2088,5.3
6047,2016,114296,102212,12084,10.6
6049,2016,3291,3034,257,7.8
6051,2016,8363,7915,448,5.4
6053,2016,218730,201975,16755,7.7
6055,2016,72929,69799,3130,4.3
6057,2016,48140,45838,2302,4.8
6059,2016,1597258,1532720,64538,4
6061,2016,179604,171549,8055,4.5
6063,2016,7848,7085,763,9.699999999999999
6065,2016,1051430,987183,64247,6.1
6067,2016,693868,656358,37510,5.4
6069,2016,30426,28397,2029,6.7
6071,2016,930088,876384,53704,5.8
6073,2016,1562997,1489140,73857,4.7
6075,2016,555264,536972,18292,3.3
6077,2016,318233,292367,25866,8.1
6079,2016,139465,133437,6028,4.3
6081,2016,441754,428282,13472,3
6083,2016,215220,204328,10892,5.1
6085,2016,1027805,989046,38759,3.8
6087,2016,143726,133730,9996,7
6089,2016,74190,69019,5171,7
6091,2016,1333,1232,101,7.6
6093,2016,17890,16370,1520,8.5
6095,2016,207235,195834,11401,5.5
6097,2016,259183,248876,10307,4
6099,2016,242669,221770,20899,8.6
6101,2016,44968,40613,4355,9.699999999999999
6103,2016,25066,23281,1785,7.1
6105,2016,4991,4638,353,7.1
6107,2016,203219,180502,22717,11.2
6109,2016,21563,20221,1342,6.2
6111,2016,425280,403083,22197,5.2
6113,2016,106058,99812,6246,5.9
6115,2016,28144,25722,2422,8.6
8001,2016,253398,244332,9066,3.6
8003,2016,7962,7640,322,4
8005,2016,340304,329761,10543,3.1
8007,2016,6360,6151,209,3.3
8009,2016,2091,2055,36,1.7
8011,2016,1850,1793,57,3.1
8013,2016,180697,175874,4823,2.7
8014,2016,36747,35684,1063,2.9
8015,2016,8834,8600,234,2.6
8017,2016,1080,1056,24,2.2
8019,2016,5681,5500,181,3.2
8021,2016,3768,3585,183,4.9
8023,2016,1727,1644,83,4.8
8025,2016,1421,1371,50,3.5
8027,2016,2016,1953,63,3.1
8029,2016,13949,13263,686,4.9
8031,2016,384721,372773,11948,3.1
8033,2016,1071,1029,42,3.9
8035,2016,177371,172638,4733,2.7
8037,2016,33696,32770,926,2.7
8039,2016,13786,13428,358,2.6
8041,2016,314454,302644,11810,3.8
8043,2016,14697,13936,761,5.2
8045,2016,30971,29888,1083,3.5
8047,2016,3481,3398,83,2.4
8049,2016,9181,8934,247,2.7
8051,2016,10127,9894,233,2.3
8053,2016,447,436,11,2.5
8055,2016,2499,2341,158,6.3
8057,2016,891,867,24,2.7
8059,2016,315094,305778,9316,3
8061,2016,846,829,17,2
8063,2016,4534,4438,96,2.1
8065,2016,4613,4481,132,2.9
8067,2016,30961,30072,889,2.9
8069,2016,187205,181951,5254,2.8
8071,2016,6182,5870,312,5
8073,2016,2277,2219,58,2.5
8075,2016,11006,10682,324,2.9
8077,2016,72056,68215,3841,5.3
8079,2016,463,453,10,2.2
8081,2016,7177,6892,285,4
8083,2016,12717,12085,632,5
8085,2016,20054,19224,830,4.1
8087,2016,15027,14508,519,3.5
8089,2016,8109,7727,382,4.7
8091,2016,2164,2083,81,3.7
8093,2016,9826,9552,274,2.8
8095,2016,2470,2421,49,2
8097,2016,10728,10365,363,3.4
8099,2016,6000,5806,194,3.2
8101,2016,73046,69551,3495,4.8
8103,2016,2736,2597,139,5.1
8105,2016,5153,4898,255,4.9
8107,2016,14894,14504,390,2.6
8109,2016,3226,3068,158,4.9
8111,2016,479,461,18,3.8
8113,2016,5181,5012,169,3.3
8115,2016,1176,1149,27,2.3
8117,2016,21109,20672,437,2.1
8119,2016,11723,11288,435,3.7
8121,2016,2917,2854,63,2.2
8123,2016,149828,144709,5119,3.4
8125,2016,5434,5318,116,2.1
9001,2016,480577,457145,23432,4.9
9003,2016,474272,448868,25404,5.4
9005,2016,104743,99796,4947,4.7
9007,2016,92277,88179,4098,4.4
9009,2016,455797,430672,25125,5.5
9011,2016,136035,129057,6978,5.1
9013,2016,85320,81489,3831,4.5
9015,2016,62764,59271,3493,5.6
10001,2016,77196,73404,3792,4.9
10003,2016,293641,280645,12996,4.4
10005,2016,101015,96477,4538,4.5
11001,2016,395021,370897,24124,6.1
12001,2016,132392,126746,5646,4.3
12003,2016,11397,10844,553,4.9
12005,2016,87761,83595,4166,4.7
12007,2016,10841,10381,460,4.2
12009,2016,262074,248726,13348,5.1
12011,2016,1002237,957296,44941,4.5
12013,2016,4976,4692,284,5.7
12015,2016,69161,65493,3668,5.3
12017,2016,47749,44552,3197,6.7
12019,2016,100841,96324,4517,4.5
12021,2016,168898,161045,7853,4.6
12023,2016,29705,28263,1442,4.9
12027,2016,13447,12741,706,5.3
12029,2016,5640,5334,306,5.4
12031,2016,466779,443960,22819,4.9
12033,2016,140696,133760,6936,4.9
12035,2016,45257,42779,2478,5.5
12037,2016,4728,4524,204,4.3
12039,2016,18172,17039,1133,6.2
12041,2016,6665,6333,332,5
12043,2016,4708,4416,292,6.2
12045,2016,5955,5679,276,4.6
12047,2016,4648,4386,262,5.6
12049,2016,9237,8626,611,6.6
12051,2016,15374,14071,1303,8.5
12053,2016,67794,63712,4082,6
12055,2016,35655,33334,2321,6.5
12057,2016,705974,674848,31126,4.4
12059,2016,6699,6339,360,5.4
12061,2016,62067,58348,3719,6
12063,2016,17307,16408,899,5.2
12065,2016,5376,5095,281,5.2
12067,2016,2962,2833,129,4.4
12069,2016,145832,138781,7051,4.8
12071,2016,328730,313612,15118,4.6
12073,2016,149944,143181,6763,4.5
12075,2016,16617,15762,855,5.1
12077,2016,2632,2498,134,5.1
12079,2016,7312,6929,383,5.2
12081,2016,170287,162567,7720,4.5
12083,2016,131780,124145,7635,5.8
12085,2016,70764,67350,3414,4.8
12086,2016,1313067,1244190,68877,5.2
12087,2016,46367,44898,1469,3.2
12089,2016,37706,36018,1688,4.5
12091,2016,93070,89347,3723,4
12093,2016,18113,17187,926,5.1
12095,2016,705308,674711,30597,4.3
12097,2016,163954,155857,8097,4.9
12099,2016,707957,674875,33082,4.7
12101,2016,222107,210767,11340,5.1
12103,2016,477373,456719,20654,4.3
12105,2016,286350,270598,15752,5.5
12107,2016,26926,25221,1705,6.3
12109,2016,118381,113922,4459,3.8
12111,2016,134948,127177,7771,5.8
12113,2016,75987,72574,3413,4.5
12115,2016,180693,172515,8178,4.5
12117,2016,241602,231320,10282,4.3
12119,2016,29330,27239,2091,7.1
12121,2016,18151,17266,885,4.9
12123,2016,8820,8346,474,5.4
12125,2016,4787,4581,206,4.3
12127,2016,245026,232679,12347,5
12129,2016,14271,13683,588,4.1
12131,2016,28889,27654,1235,4.3
12133,2016,9682,9187,495,5.1
13001,2016,9174,8589,585,6.4
13003,2016,3971,3763,208,5.2
13005,2016,4973,4713,260,5.2
13007,2016,1180,1089,91,7.7
13009,2016,17606,16401,1205,6.8
13011,2016,8801,8374,427,4.9
13013,2016,37638,35863,1775,4.7
13015,2016,48113,45649,2464,5.1
13017,2016,5538,5084,454,8.199999999999999
13019,2016,7209,6767,442,6.1
13021,2016,68537,64465,4072,5.9
13023,2016,4495,4139,356,7.9
13025,2016,7085,6609,476,6.7
13027,2016,6999,6632,367,5.2
13029,2016,16901,16079,822,4.9
13031,2016,35907,33852,2055,5.7
13033,2016,9227,8516,711,7.7
13035,2016,10361,9778,583,5.6
13037,2016,2160,2038,122,5.6
13039,2016,20318,19149,1169,5.8
13043,2016,5063,4821,242,4.8
13045,2016,53456,50247,3209,6
13047,2016,32121,30569,1552,4.8
13049,2016,4733,4466,267,5.6
13051,2016,135862,128743,7119,5.2
13053,2016,2055,1885,170,8.300000000000001
13055,2016,10419,9762,657,6.3
13057,2016,125693,120346,5347,4.3
13059,2016,58666,55434,3232,5.5
13061,2016,882,790,92,10.4
13063,2016,130556,121941,8615,6.6
13065,2016,2765,2595,170,6.1
13067,2016,409444,390646,18798,4.6
13069,2016,18057,17008,1049,5.8
13071,2016,21065,19959,1106,5.3
13073,2016,70932,67640,3292,4.6
13075,2016,7511,7105,406,5.4
13077,2016,70287,66795,3492,5
13079,2016,5668,5334,334,5.9
13081,2016,9174,8621,553,6
13083,2016,8004,7600,404,5
13085,2016,11313,10784,529,4.7
13087,2016,11455,10694,761,6.6
13089,2016,382087,361505,20582,5.4
13091,2016,7004,6495,509,7.3
13093,2016,4942,4656,286,5.8
13095,2016,38098,35492,2606,6.8
13097,2016,70108,66215,3893,5.6
13099,2016,4393,4091,302,6.9
13101,2016,1879,1798,81,4.3
13103,2016,28371,27002,1369,4.8
13105,2016,7717,7217,500,6.5
13107,2016,8432,7780,652,7.7
13109,2016,4781,4546,235,4.9
13111,2016,10811,10233,578,5.3
13113,2016,55624,53005,2619,4.7
13115,2016,43428,40822,2606,6
13117,2016,110823,106203,4620,4.2
13119,2016,9772,9261,511,5.2
13121,2016,530235,501729,28506,5.4
13123,2016,11815,11145,670,5.7
13125,2016,1266,1190,76,6
13127,2016,39114,37040,2074,5.3
13129,2016,25259,23846,1413,5.6
13131,2016,10236,9680,556,5.4
13133,2016,6593,6195,398,6
13135,2016,466965,444758,22207,4.8
13137,2016,19271,18254,1017,5.3
13139,2016,96156,91834,4322,4.5
13141,2016,2527,2315,212,8.4
13143,2016,12138,11435,703,5.8
13145,2016,16042,15260,782,4.9
13147,2016,10994,10404,590,5.4
13149,2016,4987,4693,294,5.9
13151,2016,108731,102754,5977,5.5
13153,2016,67559,63950,3609,5.3
13155,2016,3213,2962,251,7.8
13157,2016,33234,31819,1415,4.3
13159,2016,6571,6257,314,4.8
13161,2016,6217,5822,395,6.4
13163,2016,6586,6100,486,7.4
13165,2016,3157,2919,238,7.5
13167,2016,3920,3681,239,6.1
13169,2016,13771,13110,661,4.8
13171,2016,7886,7369,517,6.6
13173,2016,3822,3601,221,5.8
13175,2016,19032,17767,1265,6.6
13177,2016,14533,13852,681,4.7
13179,2016,25004,23542,1462,5.8
13181,2016,3472,3268,204,5.9
13183,2016,7412,7012,400,5.4
13185,2016,51227,48527,2700,5.3
13187,2016,15945,15183,762,4.8
13189,2016,8786,8144,642,7.3
13191,2016,5994,5644,350,5.8
13193,2016,4671,4285,386,8.300000000000001
13195,2016,13062,12417,645,4.9
13197,2016,3374,3127,247,7.3
13199,2016,8743,8143,600,6.9
13201,2016,2748,2600,148,5.4
13205,2016,8555,7994,561,6.6
13207,2016,12997,12326,671,5.2
13209,2016,3719,3442,277,7.4
13211,2016,8685,8247,438,5
13213,2016,15618,14511,1107,7.1
13215,2016,78298,72985,5313,6.8
13217,2016,49918,46931,2987,6
13219,2016,18445,17690,755,4.1
13221,2016,6908,6572,336,4.9
13223,2016,79521,75847,3674,4.6
13225,2016,11420,10621,799,7
13227,2016,14379,13680,699,4.9
13229,2016,8542,8090,452,5.3
13231,2016,8389,7954,435,5.2
13233,2016,18042,16935,1107,6.1
13235,2016,4032,3796,236,5.9
13237,2016,7939,7381,558,7
13239,2016,813,754,59,7.3
13241,2016,6687,6292,395,5.9
13243,2016,2469,2261,208,8.4
13245,2016,84693,78975,5718,6.8
13247,2016,43179,40679,2500,5.8
13249,2016,2113,1980,133,6.3
13251,2016,5229,4836,393,7.5
13253,2016,3087,2844,243,7.9
13255,2016,27746,25841,1905,6.9
13257,2016,11015,10368,647,5.9
13259,2016,2134,1998,136,6.4
13261,2016,12824,11854,970,7.6
13263,2016,2740,2557,183,6.7
13265,2016,548,510,38,6.9
13267,2016,9316,8818,498,5.3
13269,2016,3318,3070,248,7.5
13271,2016,4805,4403,402,8.4
13273,2016,3651,3414,237,6.5
13275,2016,17504,16413,1091,6.2
13277,2016,18523,17527,996,5.4
13279,2016,11767,10849,918,7.8
13281,2016,4102,3823,279,6.8
13283,2016,2737,2527,210,7.7
13285,2016,36778,34906,1872,5.1
13287,2016,3230,3021,209,6.5
13289,2016,2944,2688,256,8.699999999999999
13291,2016,10433,9939,494,4.7
13293,2016,11124,10407,717,6.4
13295,2016,29888,28224,1664,5.6
13297,2016,43313,41186,2127,4.9
13299,2016,15457,14625,832,5.4
13301,2016,2695,2508,187,6.9
13303,2016,7172,6718,454,6.3
13305,2016,11277,10505,772,6.8
13307,2016,965,882,83,8.6
13309,2016,1731,1575,156,9
13311,2016,14459,13789,670,4.6
13313,2016,44669,41939,2730,6.1
13315,2016,2716,2520,196,7.2
13317,2016,3701,3456,245,6.6
13319,2016,3645,3414,231,6.3
13321,2016,9108,8577,531,5.8
15001,2016,93057,89703,3354,3.6
15003,2016,466140,453131,13009,2.8
15007,2016,36810,35657,1153,3.1
15009,2016,87215,84564,2651,3
16001,2016,225548,218120,7428,3.3
16003,2016,1747,1626,121,6.9
16005,2016,41147,39682,1465,3.6
16007,2016,2816,2687,129,4.6
16009,2016,4019,3781,238,5.9
16011,2016,22830,22027,803,3.5
16013,2016,11867,11493,374,3.2
16015,2016,3102,2938,164,5.3
16017,2016,18921,17895,1026,5.4
16019,2016,52476,50808,1668,3.2
16021,2016,5114,4846,268,5.2
16023,2016,1295,1242,53,4.1
16025,2016,659,635,24,3.6
16027,2016,93783,89703,4080,4.4
16029,2016,3801,3664,137,3.6
16031,2016,11610,11265,345,3
16033,2016,394,381,13,3.3
16035,2016,3055,2832,223,7.3
16037,2016,2144,2035,109,5.1
16039,2016,10973,10520,453,4.1
16041,2016,6652,6448,204,3.1
16043,2016,7382,7134,248,3.4
16045,2016,7743,7379,364,4.7
16047,2016,8012,7766,246,3.1
16049,2016,6352,5992,360,5.7
16051,2016,12848,12451,397,3.1
16053,2016,11366,11008,358,3.1
16055,2016,73965,70512,3453,4.7
16057,2016,19930,19298,632,3.2
16059,2016,3414,3205,209,6.1
16061,2016,1629,1525,104,6.4
16063,2016,2646,2528,118,4.5
16065,2016,20599,20101,498,2.4
16067,2016,10893,10545,348,3.2
16069,2016,20902,20216,686,3.3
16071,2016,2204,2125,79,3.6
16073,2016,5289,5047,242,4.6
16075,2016,11275,10752,523,4.6
16077,2016,3937,3776,161,4.1
16079,2016,5126,4762,364,7.1
16081,2016,5992,5799,193,3.2
16083,2016,39633,38284,1349,3.4
16085,2016,4973,4705,268,5.4
16087,2016,4608,4354,254,5.5
17001,2016,32483,30936,1547,4.8
17003,2016,2205,1999,206,9.300000000000001
17005,2016,7878,7475,403,5.1
17007,2016,26325,24648,1677,6.4
17009,2016,2856,2760,96,3.4
17011,2016,17374,16324,1050,6
17013,2016,2374,2227,147,6.2
17015,2016,7865,7420,445,5.7
17017,2016,6213,5866,347,5.6
17019,2016,107398,102018,5380,5
17021,2016,15291,14315,976,6.4
17023,2016,8162,7687,475,5.8
17025,2016,6705,6247,458,6.8
17027,2016,20450,19537,913,4.5
17029,2016,24523,23075,1448,5.9
17031,2016,2660740,2500024,160716,6
17033,2016,9026,8463,563,6.2
17035,2016,5981,5670,311,5.2
17037,2016,55182,52231,2951,5.3
17039,2016,7941,7489,452,5.7
17041,2016,10282,9797,485,4.7
17043,2016,516207,491840,24367,4.7
17045,2016,9706,9124,582,6
17047,2016,2972,2799,173,5.8
17049,2016,18687,17804,883,4.7
17051,2016,9753,9110,643,6.6
17053,2016,6653,6292,361,5.4
17055,2016,16692,15340,1352,8.1
17057,2016,15803,14635,1168,7.4
17059,2016,2534,2342,192,7.6
17061,2016,6070,5716,354,5.8
17063,2016,25722,23999,1723,6.7
17065,2016,4257,3990,267,6.3
17067,2016,8829,8253,576,6.5
17069,2016,1399,1263,136,9.699999999999999
17071,2016,3717,3490,227,6.1
17073,2016,25215,23692,1523,6
17075,2016,14795,13980,815,5.5
17077,2016,28679,27133,1546,5.4
17079,2016,4647,4355,292,6.3
17081,2016,17568,16442,1126,6.4
17083,2016,11055,10410,645,5.8
17085,2016,11376,10764,612,5.4
17087,2016,4209,3842,367,8.699999999999999
17089,2016,270169,255214,14955,5.5
17091,2016,54706,51162,3544,6.5
17093,2016,67876,64412,3464,5.1
17095,2016,22941,21528,1413,6.2
17097,2016,371791,352296,19495,5.2
17099,2016,57117,53251,3866,6.8
17101,2016,6176,5717,459,7.4
17103,2016,18021,17095,926,5.1
17105,2016,17027,16105,922,5.4
17107,2016,13042,12346,696,5.3
17109,2016,14027,13147,880,6.3
17111,2016,167654,158888,8766,5.2
17113,2016,90527,85947,4580,5.1
17115,2016,50568,47229,3339,6.6
17117,2016,23358,21966,1392,6
17119,2016,135113,127149,7964,5.9
17121,2016,18026,16875,1151,6.4
17123,2016,5631,5257,374,6.6
17125,2016,6439,5979,460,7.1
17127,2016,5992,5564,428,7.1
17129,2016,6747,6431,316,4.7
17131,2016,8222,7711,511,6.2
17133,2016,18486,17735,751,4.1
17135,2016,12110,11250,860,7.1
17137,2016,16935,16098,837,4.9
17139,2016,7444,7103,341,4.6
17141,2016,25791,24265,1526,5.9
17143,2016,88039,81962,6077,6.9
17145,2016,8705,8086,619,7.1
17147,2016,8691,8269,422,4.9
17149,2016,7508,7125,383,5.1
17151,2016,1761,1640,121,6.9
17153,2016,2194,2008,186,8.5
17155,2016,3107,2933,174,5.6
17157,2016,14548,13819,729,5
17159,2016,7540,7093,447,5.9
17161,2016,72081,67558,4523,6.3
17163,2016,127192,119462,7730,6.1
17165,2016,10050,9189,861,8.6
17167,2016,103862,98686,5176,5
17169,2016,3358,3169,189,5.6
17171,2016,2527,2384,143,5.7
17173,2016,10396,9800,596,5.7
17175,2016,2759,2556,203,7.4
17177,2016,21407,20151,1256,5.9
17179,2016,65774,61543,4231,6.4
17181,2016,7524,6966,558,7.4
17183,2016,34892,32361,2531,7.3
17185,2016,5753,5392,361,6.3
17187,2016,8697,8238,459,5.3
17189,2016,9645,9282,363,3.8
17191,2016,7302,6679,623,8.5
17193,2016,6889,6437,452,6.6
17195,2016,28728,27061,1667,5.8
17197,2016,362361,340776,21585,6
17199,2016,32325,30336,1989,6.2
17201,2016,141312,131886,9426,6.7
17203,2016,19351,18289,1062,5.5
18001,2016,17037,16427,610,3.6
18003,2016,180853,173132,7721,4.3
18005,2016,44444,42938,1506,3.4
18007,2016,4565,4372,193,4.2
18009,2016,5336,5050,286,5.4
18011,2016,34853,33677,1176,3.4
18013,2016,7521,7219,302,4
18015,2016,10108,9679,429,4.2
18017,2016,18047,17209,838,4.6
18019,2016,60529,58008,2521,4.2
18021,2016,12384,11806,578,4.7
18023,2016,17150,16484,666,3.9
18025,2016,4999,4717,282,5.6
18027,2016,15972,15407,565,3.5
18029,2016,25596,24390,1206,4.7
18031,2016,14553,14035,518,3.6
18033,2016,22232,21361,871,3.9
18035,2016,55079,52254,2825,5.1
18037,2016,23392,22664,728,3.1
18039,2016,108457,104678,3779,3.5
18041,2016,9350,8812,538,5.8
18043,2016,40981,39303,1678,4.1
18045,2016,7970,7507,463,5.8
18047,2016,11477,10979,498,4.3
18049,2016,9887,9423,464,4.7
18051,2016,19197,18501,696,3.6
18053,2016,32141,30556,1585,4.9
18055,2016,13741,12843,898,6.5
18057,2016,174473,168883,5590,3.2
18059,2016,38682,37218,1464,3.8
18061,2016,19955,19116,839,4.2
18063,2016,85776,82780,2996,3.5
18065,2016,22114,21093,1021,4.6
18067,2016,38078,36304,1774,4.7
18069,2016,18687,17928,759,4.1
18071,2016,22344,21527,817,3.7
18073,2016,16570,15688,882,5.3
18075,2016,9945,9494,451,4.5
18077,2016,15285,14573,712,4.7
18079,2016,13265,12635,630,4.7
18081,2016,80246,77330,2916,3.6
18083,2016,19063,18230,833,4.4
18085,2016,41495,39941,1554,3.7
18087,2016,19422,18752,670,3.4
18089,2016,232236,217542,14694,6.3
18091,2016,48647,45786,2861,5.9
18093,2016,20593,19423,1170,5.7
18095,2016,58964,55991,2973,5
18097,2016,481434,459887,21547,4.5
18099,2016,24324,23412,912,3.7
18101,2016,5150,4939,211,4.1
18103,2016,16085,15326,759,4.7
18105,2016,67986,64824,3162,4.7
18107,2016,19156,18419,737,3.8
18109,2016,36037,34503,1534,4.3
18111,2016,7037,6644,393,5.6
18113,2016,23329,22382,947,4.1
18115,2016,3226,3067,159,4.9
18117,2016,8880,8429,451,5.1
18119,2016,9259,8744,515,5.6
18121,2016,7267,6888,379,5.2
18123,2016,9460,9029,431,4.6
18125,2016,6330,6055,275,4.3
18127,2016,86273,81852,4421,5.1
18129,2016,13450,12919,531,3.9
18131,2016,6379,6094,285,4.5
18133,2016,16604,15854,750,4.5
18135,2016,12668,12098,570,4.5
18137,2016,14066,13420,646,4.6
18139,2016,8978,8639,339,3.8
18141,2016,134119,128039,6080,4.5
18143,2016,10475,9967,508,4.8
18145,2016,22954,22037,917,4
18147,2016,10975,10525,450,4.1
18149,2016,10858,10271,587,5.4
18151,2016,20081,19346,735,3.7
18153,2016,8699,8188,511,5.9
18155,2016,4996,4752,244,4.9
18157,2016,94383,90548,3835,4.1
18159,2016,8527,8199,328,3.8
18161,2016,3637,3490,147,4
18163,2016,93222,89389,3833,4.1
18165,2016,7271,6792,479,6.6
18167,2016,49375,46714,2661,5.4
18169,2016,15477,14818,659,4.3
18171,2016,4111,3912,199,4.8
18173,2016,32481,31169,1312,4
18175,2016,13682,13056,626,4.6
18177,2016,30950,29465,1485,4.8
18179,2016,14167,13662,505,3.6
18181,2016,13643,13100,543,4
18183,2016,17234,16564,670,3.9
19001,2016,4222,4097,125,3
19003,2016,2209,2152,57,2.6
19005,2016,7648,7269,379,5
19007,2016,6142,5851,291,4.7
19009,2016,3267,3159,108,3.3
19011,2016,13561,13071,490,3.6
19013,2016,69082,65879,3203,4.6
19015,2016,15072,14651,421,2.8
19017,2016,13868,13372,496,3.6
19019,2016,11171,10711,460,4.1
19021,2016,11481,11076,405,3.5
19023,2016,8006,7658,348,4.3
19025,2016,4509,4339,170,3.8
19027,2016,11247,10958,289,2.6
19029,2016,7244,7007,237,3.3
19031,2016,10828,10468,360,3.3
19033,2016,23053,22224,829,3.6
19035,2016,6303,6074,229,3.6
19037,2016,6408,6124,284,4.4
19039,2016,4817,4655,162,3.4
19041,2016,8695,8360,335,3.9
19043,2016,10273,9837,436,4.2
19045,2016,23751,22578,1173,4.9
19047,2016,8414,7954,460,5.5
19049,2016,45693,44488,1205,2.6
19051,2016,4278,4096,182,4.3
19053,2016,4393,4252,141,3.2
19055,2016,10698,10327,371,3.5
19057,2016,19986,18998,988,4.9
19059,2016,10273,9831,442,4.3
19061,2016,54537,52594,1943,3.6
19063,2016,5581,5343,238,4.3
19065,2016,10683,10208,475,4.4
19067,2016,8666,8351,315,3.6
19069,2016,5929,5723,206,3.5
19071,2016,3977,3846,131,3.3
19073,2016,5651,5474,177,3.1
19075,2016,6617,6388,229,3.5
19077,2016,5609,5407,202,3.6
19079,2016,7121,6853,268,3.8
19081,2016,6373,6201,172,2.7
19083,2016,8550,8217,333,3.9
19085,2016,7430,7179,251,3.4
19087,2016,9536,9197,339,3.6
19089,2016,5315,5124,191,3.6
19091,2016,5372,5217,155,2.9
19093,2016,4014,3911,103,2.6
19095,2016,10530,10202,328,3.1
19097,2016,11034,10571,463,4.2
19099,2016,19194,18512,682,3.6
19101,2016,9160,8824,336,3.7
19103,2016,84086,81903,2183,2.6
19105,2016,10660,10203,457,4.3
19107,2016,5307,5079,228,4.3
19109,2016,8870,8638,232,2.6
19111,2016,17416,16364,1052,6
19113,2016,118477,114131,4346,3.7
19115,2016,6087,5848,239,3.9
19117,2016,4370,4231,139,3.2
19119,2016,7068,6924,144,2
19121,2016,8229,7937,292,3.5
19123,2016,11768,11330,438,3.7
19125,2016,17400,16875,525,3
19127,2016,19085,18150,935,4.9
19129,2016,7387,7118,269,3.6
19131,2016,5864,5710,154,2.6
19133,2016,4713,4520,193,4.1
19135,2016,3947,3765,182,4.6
19137,2016,5099,4919,180,3.5
19139,2016,22372,21520,852,3.8
19141,2016,8338,8107,231,2.8
19143,2016,3633,3537,96,2.6
19145,2016,6450,6126,324,5
19147,2016,4953,4799,154,3.1
19149,2016,14968,14585,383,2.6
19151,2016,4305,4182,123,2.9
19153,2016,256655,247743,8912,3.5
19155,2016,48137,46503,1634,3.4
19157,2016,10395,10038,357,3.4
19159,2016,2600,2509,91,3.5
19161,2016,5480,5315,165,3
19163,2016,86497,82592,3905,4.5
19165,2016,6805,6605,200,2.9
19167,2016,20631,20157,474,2.3
19169,2016,56811,55478,1333,2.3
19171,2016,9742,9334,408,4.2
19173,2016,3221,3126,95,2.9
19175,2016,6497,6250,247,3.8
19177,2016,3849,3708,141,3.7
19179,2016,17846,16811,1035,5.8
19181,2016,27037,26172,865,3.2
19183,2016,12322,11961,361,2.9
19185,2016,2833,2726,107,3.8
19187,2016,20379,19564,815,4
19189,2016,5185,5005,180,3.5
19191,2016,12029,11606,423,3.5
19193,2016,55604,53622,1982,3.6
19195,2016,4258,4112,146,3.4
19197,2016,6674,6399,275,4.1
20001,2016,6432,6073,359,5.6
20003,2016,4169,3991,178,4.3
20005,2016,7038,6600,438,6.2
20007,2016,2524,2431,93,3.7
20009,2016,14008,13380,628,4.5
20011,2016,7120,6774,346,4.9
20013,2016,5159,4972,187,3.6
20015,2016,32159,30816,1343,4.2
20017,2016,1405,1356,49,3.5
20019,2016,1539,1459,80,5.2
20021,2016,10278,9822,456,4.4
20023,2016,1342,1305,37,2.8
20025,2016,1115,1084,31,2.8
20027,2016,4030,3866,164,4.1
20029,2016,4252,4077,175,4.1
20031,2016,4278,4013,265,6.2
20033,2016,970,940,30,3.1
20035,2016,16891,16143,748,4.4
20037,2016,18894,17984,910,4.8
20039,2016,1291,1240,51,4
20041,2016,9157,8752,405,4.4
20043,2016,4269,4104,165,3.9
20045,2016,65198,62893,2305,3.5
20047,2016,1652,1602,50,3
20049,2016,1187,1128,59,5
20051,2016,16994,16469,525,3.1
20053,2016,2831,2722,109,3.9
20055,2016,20129,19507,622,3.1
20057,2016,17865,17300,565,3.2
20059,2016,14210,13614,596,4.2
20061,2016,12044,11365,679,5.6
20063,2016,1449,1414,35,2.4
20065,2016,1223,1169,54,4.4
20067,2016,3769,3635,134,3.6
20069,2016,3406,3329,77,2.3
20071,2016,911,892,19,2.1
20073,2016,3319,3157,162,4.9
20075,2016,1641,1597,44,2.7
20077,2016,2878,2775,103,3.6
20079,2016,17186,16459,727,4.2
20081,2016,2302,2242,60,2.6
20083,2016,1028,1001,27,2.6
20085,2016,7251,7000,251,3.5
20087,2016,10205,9808,397,3.9
20089,2016,1329,1272,57,4.3
20091,2016,327981,317290,10691,3.3
20093,2016,2056,1991,65,3.2
20095,2016,3524,3369,155,4.4
20097,2016,1418,1379,39,2.8
20099,2016,10722,10143,579,5.4
20101,2016,810,785,25,3.1
20103,2016,35747,34206,1541,4.3
20105,2016,1735,1676,59,3.4
20107,2016,4338,4059,279,6.4
20109,2016,1721,1677,44,2.6
20111,2016,16802,16114,688,4.1
20113,2016,16321,15806,515,3.2
20115,2016,6114,5873,241,3.9
20117,2016,5556,5388,168,3
20119,2016,2374,2310,64,2.7
20121,2016,17003,16296,707,4.2
20123,2016,3692,3570,122,3.3
20125,2016,15982,15002,980,6.1
20127,2016,3047,2930,117,3.8
20129,2016,1342,1290,52,3.9
20131,2016,5890,5732,158,2.7
20133,2016,6050,5616,434,7.2
20135,2016,1421,1372,49,3.4
20137,2016,2869,2799,70,2.4
20139,2016,8049,7694,355,4.4
20141,2016,2057,1987,70,3.4
20143,2016,3159,3039,120,3.8
20145,2016,3206,3100,106,3.3
20147,2016,2854,2764,90,3.2
20149,2016,12138,11714,424,3.5
20151,2016,5098,4891,207,4.1
20153,2016,1543,1506,37,2.4
20155,2016,30104,28778,1326,4.4
20157,2016,2541,2471,70,2.8
20159,2016,5299,5088,211,4
20161,2016,34848,33666,1182,3.4
20163,2016,2666,2540,126,4.7
20165,2016,1730,1661,69,4
20167,2016,3570,3420,150,4.2
20169,2016,30078,28956,1122,3.7
20171,2016,2884,2813,71,2.5
20173,2016,247016,235528,11488,4.7
20175,2016,10220,9775,445,4.4
20177,2016,91580,87910,3670,4
20179,2016,1448,1413,35,2.4
20181,2016,2938,2841,97,3.3
20183,2016,2031,1966,65,3.2
20185,2016,2092,2015,77,3.7
20187,2016,1070,1040,30,2.8
20189,2016,2905,2790,115,4
20191,2016,10920,10457,463,4.2
20193,2016,4347,4228,119,2.7
20195,2016,1474,1415,59,4
20197,2016,3702,3570,132,3.6
20199,2016,859,836,23,2.7
20201,2016,3080,2979,101,3.3
20203,2016,1204,1176,28,2.3
20205,2016,4111,3864,247,6
20207,2016,1616,1523,93,5.8
20209,2016,76353,72109,4244,5.6
21001,2016,7085,6614,471,6.6
21003,2016,8850,8466,384,4.3
21005,2016,11455,10991,464,4.1
21007,2016,3643,3316,327,9
21009,2016,18854,17962,892,4.7
21011,2016,4759,4406,353,7.4
21013,2016,8659,7859,800,9.199999999999999
21015,2016,67249,64670,2579,3.8
21017,2016,9877,9404,473,4.8
21019,2016,18548,17036,1512,8.199999999999999
21021,2016,12310,11696,614,5
21023,2016,3831,3599,232,6.1
21025,2016,3747,3376,371,9.9
21027,2016,7737,7246,491,6.3
21029,2016,40517,38822,1695,4.2
21031,2016,5160,4877,283,5.5
21033,2016,5354,5061,293,5.5
21035,2016,18688,17837,851,4.6
21037,2016,48706,46831,1875,3.8
21039,2016,2564,2397,167,6.5
21041,2016,5182,4924,258,5
21043,2016,9943,8888,1055,10.6
21045,2016,6689,6363,326,4.9
21047,2016,24890,23351,1539,6.2
21049,2016,17018,16194,824,4.8
21051,2016,5454,4898,556,10.2
21053,2016,3750,3466,284,7.6
21055,2016,4022,3809,213,5.3
21057,2016,2890,2724,166,5.7
21059,2016,46674,44577,2097,4.5
21061,2016,4805,4505,300,6.2
21063,2016,2099,1856,243,11.6
21065,2016,5241,4930,311,5.9
21067,2016,171402,165244,6158,3.6
21069,2016,5945,5572,373,6.3
21071,2016,11459,10156,1303,11.4
21073,2016,24438,23436,1002,4.1
21075,2016,2067,1923,144,7
21077,2016,3903,3713,190,4.9
21079,2016,7524,7156,368,4.9
21081,2016,11347,10792,555,4.9
21083,2016,15306,14348,958,6.3
21085,2016,10728,10002,726,6.8
21087,2016,5000,4773,227,4.5
21089,2016,13891,12681,1210,8.699999999999999
21091,2016,4039,3821,218,5.4
21093,2016,47783,45627,2156,4.5
21095,2016,6747,5854,893,13.2
21097,2016,8492,8089,403,4.7
21099,2016,7901,7525,376,4.8
21101,2016,21600,20567,1033,4.8
21103,2016,7925,7597,328,4.1
21105,2016,1921,1805,116,6
21107,2016,19635,18506,1129,5.7
21109,2016,4168,3836,332,8
21111,2016,386617,369452,17165,4.4
21113,2016,25654,24644,1010,3.9
21115,2016,7015,6288,727,10.4
21117,2016,84703,81200,3503,4.1
21119,2016,4561,4030,531,11.6
21121,2016,9899,9103,796,8
21123,2016,5898,5624,274,4.6
21125,2016,23913,22421,1492,6.2
21127,2016,5045,4491,554,11
21129,2016,1899,1712,187,9.800000000000001
21131,2016,2792,2413,379,13.6
21133,2016,6429,5627,802,12.5
21135,2016,4745,4275,470,9.9
21137,2016,9149,8588,561,6.1
21139,2016,3687,3420,267,7.2
21141,2016,11731,11211,520,4.4
21143,2016,2960,2785,175,5.9
21145,2016,29002,27318,1684,5.8
21147,2016,4603,4229,374,8.1
21149,2016,4331,4121,210,4.8
21151,2016,45097,43198,1899,4.2
21153,2016,3148,2522,626,19.9
21155,2016,9400,8999,401,4.3
21157,2016,14910,14039,871,5.8
21159,2016,3085,2765,320,10.4
21161,2016,7138,6679,459,6.4
21163,2016,12088,11461,627,5.2
21165,2016,2393,2185,208,8.699999999999999
21167,2016,9888,9406,482,4.9
21169,2016,4119,3929,190,4.6
21171,2016,4600,4405,195,4.2
21173,2016,11854,11086,768,6.5
21175,2016,4486,4124,362,8.1
21177,2016,11363,10526,837,7.4
21179,2016,21698,20704,994,4.6
21181,2016,3219,3032,187,5.8
21183,2016,9524,8882,642,6.7
21185,2016,31913,30822,1091,3.4
21187,2016,5488,5250,238,4.3
21189,2016,1122,1011,111,9.9
21191,2016,6849,6518,331,4.8
21193,2016,8557,7624,933,10.9
21195,2016,20245,18029,2216,10.9
21197,2016,4959,4601,358,7.2
21199,2016,25382,23989,1393,5.5
21201,2016,805,755,50,6.2
21203,2016,6683,6272,411,6.1
21205,2016,10574,9942,632,6
21207,2016,6138,5619,519,8.5
21209,2016,27978,26908,1070,3.8
21211,2016,23797,22942,855,3.6
21213,2016,8389,8011,378,4.5
21215,2016,9651,9281,370,3.8
21217,2016,12215,11607,608,5
21219,2016,5302,5064,238,4.5
21221,2016,5818,5490,328,5.6
21223,2016,3868,3658,210,5.4
21225,2016,6164,5742,422,6.8
21227,2016,61962,59522,2440,3.9
21229,2016,6080,5817,263,4.3
21231,2016,7262,6700,562,7.7
21233,2016,5832,5479,353,6.1
21235,2016,13350,12463,887,6.6
21237,2016,1919,1723,196,10.2
21239,2016,14753,14276,477,3.2
22001,2016,24508,22697,1811,7.4
22003,2016,8899,8327,572,6.4
22005,2016,61982,58949,3033,4.9
22007,2016,9206,8433,773,8.4
22009,2016,15682,14574,1108,7.1
22011,2016,15063,14151,912,6.1
22013,2016,5664,5233,431,7.6
22015,2016,57579,54516,3063,5.3
22017,2016,107031,99951,7080,6.6
22019,2016,102869,97954,4915,4.8
22021,2016,3982,3678,304,7.6
22023,2016,3817,3650,167,4.4
22025,2016,3423,3105,318,9.300000000000001
22027,2016,5950,5553,397,6.7
22029,2016,7250,6651,599,8.300000000000001
22031,2016,10888,10088,800,7.3
22033,2016,232108,220144,11964,5.2
22035,2016,2139,1891,248,11.6
22037,2016,8102,7635,467,5.8
22039,2016,12670,11731,939,7.4
22041,2016,7279,6619,660,9.1
22043,2016,8325,7743,582,7
22045,2016,30110,27282,2828,9.4
22047,2016,14108,13141,967,6.9
22049,2016,7083,6688,395,5.6
22051,2016,216473,205046,11427,5.3
22053,2016,13574,12757,817,6
22055,2016,114343,107328,7015,6.1
22057,2016,43290,40569,2721,6.3
22059,2016,6270,5855,415,6.6
22061,2016,21462,20129,1333,6.2
22063,2016,68671,65194,3477,5.1
22065,2016,3835,3491,344,9
22067,2016,10621,9591,1030,9.699999999999999
22069,2016,16711,15587,1124,6.7
22071,2016,179955,169401,10554,5.9
22073,2016,71551,67199,4352,6.1
22075,2016,10184,9639,545,5.4
22077,2016,9960,9314,646,6.5
22079,2016,57272,53741,3531,6.2
22081,2016,3808,3579,229,6
22083,2016,8445,7818,627,7.4
22085,2016,9137,8505,632,6.9
22087,2016,19546,18357,1189,6.1
22089,2016,25319,23975,1344,5.3
22091,2016,4390,4054,336,7.7
22093,2016,9606,8888,718,7.5
22095,2016,20054,18683,1371,6.8
22097,2016,32807,30158,2649,8.1
22099,2016,22963,21183,1780,7.8
22101,2016,21939,19880,2059,9.4
22103,2016,117481,111641,5840,5
22105,2016,54158,50506,3652,6.7
22107,2016,1626,1467,159,9.800000000000001
22109,2016,48948,45538,3410,7
22111,2016,9242,8636,606,6.6
22113,2016,24701,22821,1880,7.6
22115,2016,16928,15702,1226,7.2
22117,2016,16943,15754,1189,7
22119,2016,15198,13902,1296,8.5
22121,2016,13239,12534,705,5.3
22123,2016,4104,3613,491,12
22125,2016,5328,5052,276,5.2
22127,2016,5185,4783,402,7.8
23001,2016,55245,53266,1979,3.6
23003,2016,31419,29714,1705,5.4
23005,2016,161698,156997,4701,2.9
23007,2016,14423,13779,644,4.5
23009,2016,29129,27817,1312,4.5
23011,2016,62194,59932,2262,3.6
23013,2016,20675,19948,727,3.5
23015,2016,16986,16358,628,3.7
23017,2016,26522,25297,1225,4.6
23019,2016,76854,73529,3325,4.3
23021,2016,7462,7092,370,5
23023,2016,19160,18592,568,3
23025,2016,23444,22128,1316,5.6
23027,2016,20827,19955,872,4.2
23029,2016,13985,13211,774,5.5
23031,2016,110962,107223,3739,3.4
24001,2016,32492,30460,2032,6.3
24003,2016,304143,292511,11632,3.8
24005,2016,446180,425357,20823,4.7
24009,2016,48896,46998,1898,3.9
24011,2016,17704,16855,849,4.8
24013,2016,93288,89884,3404,3.6
24015,2016,52752,49984,2768,5.2
24017,2016,84078,80496,3582,4.3
24019,2016,15926,14933,993,6.2
24021,2016,128923,123872,5051,3.9
24023,2016,15542,14657,885,5.7
24025,2016,136631,130843,5788,4.2
24027,2016,179621,173675,5946,3.3
24029,2016,10265,9764,501,4.9
24031,2016,546204,527278,18926,3.5
24033,2016,501485,479096,22389,4.5
24035,2016,26647,25601,1046,3.9
24037,2016,54902,52562,2340,4.3
24039,2016,9260,8586,674,7.3
24041,2016,19579,18755,824,4.2
24043,2016,75569,71680,3889,5.1
24045,2016,50562,47402,3160,6.2
24047,2016,25291,22935,2356,9.300000000000001
24510,2016,290265,271061,19204,6.6
25001,2016,111595,106122,5473,4.9
25003,2016,64353,61454,2899,4.5
25005,2016,290659,276376,14283,4.9
25007,2016,9349,8866,483,5.2
25009,2016,410540,394209,16331,4
25011,2016,39535,38150,1385,3.5
25013,2016,221992,210339,11653,5.2
25015,2016,88038,84846,3192,3.6
25017,2016,873687,846042,27645,3.2
25019,2016,7047,6734,313,4.4
25021,2016,372620,360049,12571,3.4
25023,2016,270868,259853,11015,4.1
25025,2016,427223,412113,15110,3.5
25027,2016,430028,412400,17628,4.1
26001,2016,3827,3534,293,7.7
26003,2016,3263,2994,269,8.199999999999999
26005,2016,61265,58880,2385,3.9
26007,2016,13646,12834,812,6
26009,2016,10065,9354,711,7.1
26011,2016,6119,5612,507,8.300000000000001
26013,2016,3219,2954,265,8.199999999999999
26015,2016,30738,29508,1230,4
26017,2016,51874,49042,2832,5.5
26019,2016,8835,8254,581,6.6
26021,2016,73776,70115,3661,5
26023,2016,19097,18177,920,4.8
26025,2016,64390,61295,3095,4.8
26027,2016,24334,23194,1140,4.7
26029,2016,13053,12330,723,5.5
26031,2016,10813,9795,1018,9.4
26033,2016,16383,15126,1257,7.7
26035,2016,11951,11077,874,7.3
26037,2016,40488,38993,1495,3.7
26039,2016,5365,4959,406,7.6
26041,2016,17114,15992,1122,6.6
26043,2016,12501,11852,649,5.2
26045,2016,56875,54530,2345,4.1
26047,2016,17592,16446,1146,6.5
26049,2016,182491,172185,10306,5.6
26051,2016,9883,9193,690,7
26053,2016,6333,5945,388,6.1
26055,2016,49365,47247,2118,4.3
26057,2016,18162,17222,940,5.2
26059,2016,21169,20098,1071,5.1
26061,2016,16559,15545,1014,6.1
26063,2016,15992,15165,827,5.2
26065,2016,148872,142487,6385,4.3
26067,2016,29646,28395,1251,4.2
26069,2016,10106,9370,736,7.3
26071,2016,5216,4878,338,6.5
26073,2016,35341,33681,1660,4.7
26075,2016,74383,70781,3602,4.8
26077,2016,131966,126621,5345,4.1
26079,2016,7717,7163,554,7.2
26081,2016,350238,337914,12324,3.5
26083,2016,941,860,81,8.6
26085,2016,3751,3470,281,7.5
26087,2016,40758,38137,2621,6.4
26089,2016,10571,10057,514,4.9
26091,2016,47334,45161,2173,4.6
26093,2016,100123,96031,4092,4.1
26095,2016,2401,2239,162,6.7
26097,2016,5188,4675,513,9.9
26099,2016,436316,413581,22735,5.2
26101,2016,10530,9840,690,6.6
26103,2016,33309,31408,1901,5.7
26105,2016,14271,13440,831,5.8
26107,2016,19098,18024,1074,5.6
26109,2016,11247,10666,581,5.2
26111,2016,41012,39079,1933,4.7
26113,2016,7023,6605,418,6
26115,2016,76387,73088,3299,4.3
26117,2016,27911,26432,1479,5.3
26119,2016,3059,2748,311,10.2
26121,2016,77421,73194,4227,5.5
26123,2016,23322,22181,1141,4.9
26125,2016,653664,626554,27110,4.1
26127,2016,12318,11415,903,7.3
26129,2016,8234,7592,642,7.8
26131,2016,2202,2014,188,8.5
26133,2016,10429,9834,595,5.7
26135,2016,2906,2693,213,7.3
26137,2016,11684,10988,696,6
26139,2016,155338,150104,5234,3.4
26141,2016,5286,4780,506,9.6
26143,2016,7866,7200,666,8.5
26145,2016,88569,83845,4724,5.3
26147,2016,74762,70209,4553,6.1
26149,2016,29114,27913,1201,4.1
26151,2016,19407,18199,1208,6.2
26153,2016,3388,3079,309,9.1
26155,2016,33477,31714,1763,5.3
26157,2016,24217,22694,1523,6.3
26159,2016,35454,33415,2039,5.8
26161,2016,191443,184440,7003,3.7
26163,2016,780565,731656,48909,6.3
26165,2016,14694,13832,862,5.9
27001,2016,7052,6558,494,7
27003,2016,192557,185393,7164,3.7
27005,2016,18621,17771,850,4.6
27007,2016,23757,22519,1238,5.2
27009,2016,21850,20888,962,4.4
27011,2016,2713,2583,130,4.8
27013,2016,39754,38480,1274,3.2
27015,2016,14570,13960,610,4.2
27017,2016,17800,16859,941,5.3
27019,2016,56518,54657,1861,3.3
27021,2016,14203,13237,966,6.8
27023,2016,6989,6675,314,4.5
27025,2016,29245,27983,1262,4.3
27027,2016,35734,34508,1226,3.4
27029,2016,4731,4278,453,9.6
27031,2016,3104,2964,140,4.5
27033,2016,5551,5154,397,7.2
27035,2016,31944,30322,1622,5.1
27037,2016,235892,227902,7990,3.4
27039,2016,11596,11166,430,3.7
27041,2016,20299,19593,706,3.5
27043,2016,7346,7024,322,4.4
27045,2016,11537,11073,464,4
27047,2016,16340,15717,623,3.8
27049,2016,26938,25938,1000,3.7
27051,2016,3298,3144,154,4.7
27053,2016,687887,664996,22891,3.3
27055,2016,10636,10221,415,3.9
27057,2016,9827,9191,636,6.5
27059,2016,20744,19778,966,4.7
27061,2016,22098,20214,1884,8.5
27063,2016,6119,5843,276,4.5
27065,2016,9021,8436,585,6.5
27067,2016,24271,23351,920,3.8
27069,2016,2412,2302,110,4.6
27071,2016,6183,5659,524,8.5
27073,2016,3631,3476,155,4.3
27075,2016,5435,5090,345,6.3
27077,2016,2391,2276,115,4.8
27079,2016,15611,14850,761,4.9
27081,2016,3395,3271,124,3.7
27083,2016,15238,14697,541,3.6
27085,2016,19843,18969,874,4.4
27087,2016,2397,2259,138,5.8
27089,2016,5636,5225,411,7.3
27091,2016,10497,10066,431,4.1
27093,2016,13306,12710,596,4.5
27095,2016,12765,12006,759,5.9
27097,2016,17925,16922,1003,5.6
27099,2016,20589,19938,651,3.2
27101,2016,4973,4738,235,4.7
27103,2016,20424,19847,577,2.8
27105,2016,11495,11062,433,3.8
27107,2016,3454,3289,165,4.8
27109,2016,85507,82964,2543,3
27111,2016,31400,30036,1364,4.3
27113,2016,9074,8553,521,5.7
27115,2016,14887,14020,867,5.8
27117,2016,4918,4731,187,3.8
27119,2016,17205,16459,746,4.3
27121,2016,6324,6100,224,3.5
27123,2016,283359,273167,10192,3.6
27125,2016,2297,2129,168,7.3
27127,2016,8349,8007,342,4.1
27129,2016,8444,8001,443,5.2
27131,2016,36228,34960,1268,3.5
27133,2016,5930,5793,137,2.3
27135,2016,8276,7854,422,5.1
27137,2016,102962,97080,5882,5.7
27139,2016,80987,78387,2600,3.2
27141,2016,50867,48801,2066,4.1
27143,2016,8522,8158,364,4.3
27145,2016,89247,85890,3357,3.8
27147,2016,21262,20505,757,3.6
27149,2016,5671,5501,170,3
27151,2016,5064,4792,272,5.4
27153,2016,12951,12342,609,4.7
27155,2016,1713,1646,67,3.9
27157,2016,12055,11611,444,3.7
27159,2016,6270,5899,371,5.9
27161,2016,9499,9092,407,4.3
27163,2016,139295,134651,4644,3.3
27165,2016,6600,6279,321,4.9
27167,2016,3733,3612,121,3.2
27169,2016,29365,28327,1038,3.5
27171,2016,73353,70529,2824,3.8
27173,2016,5497,5287,210,3.8
28001,2016,11258,10331,927,8.199999999999999
28003,2016,15831,15012,819,5.2
28005,2016,4512,4182,330,7.3
28007,2016,7018,6550,468,6.7
28009,2016,3050,2846,204,6.7
28011,2016,13411,12444,967,7.2
28013,2016,6189,5859,330,5.3
28015,2016,3566,3308,258,7.2
28017,2016,7097,6633,464,6.5
28019,2016,3729,3519,210,5.6
28021,2016,3093,2743,350,11.3
28023,2016,6080,5670,410,6.7
28025,2016,8024,7375,649,8.1
28027,2016,9222,8424,798,8.699999999999999
28029,2016,11286,10553,733,6.5
28031,2016,8161,7719,442,5.4
28033,2016,87344,83679,3665,4.2
28035,2016,33404,31501,1903,5.7
28037,2016,2855,2651,204,7.1
28039,2016,8818,8168,650,7.4
28041,2016,4289,3978,311,7.3
28043,2016,9615,9125,490,5.1
28045,2016,18885,17740,1145,6.1
28047,2016,86791,82022,4769,5.5
28049,2016,110065,104105,5960,5.4
28051,2016,5981,5326,655,11
28053,2016,2375,2105,270,11.4
28055,2016,401,345,56,14
28057,2016,10409,9884,525,5
28059,2016,59142,55271,3871,6.5
28061,2016,6196,5723,473,7.6
28063,2016,2228,1897,331,14.9
28065,2016,4183,3840,343,8.199999999999999
28067,2016,25811,24239,1572,6.1
28069,2016,3556,3247,309,8.699999999999999
28071,2016,26008,24746,1262,4.9
28073,2016,29627,28288,1339,4.5
28075,2016,31802,29942,1860,5.8
28077,2016,4679,4347,332,7.1
28079,2016,7759,7291,468,6
28081,2016,40839,38861,1978,4.8
28083,2016,10340,9406,934,9
28085,2016,14433,13616,817,5.7
28087,2016,25535,23975,1560,6.1
28089,2016,53406,51114,2292,4.3
28091,2016,10271,9601,670,6.5
28093,2016,14566,13692,874,6
28095,2016,15648,14666,982,6.3
28097,2016,4240,3970,270,6.4
28099,2016,10708,10095,613,5.7
28101,2016,8647,8140,507,5.9
28103,2016,3967,3640,327,8.199999999999999
28105,2016,23069,21823,1246,5.4
28107,2016,13192,12226,966,7.3
28109,2016,23234,21853,1381,5.9
28111,2016,4360,4050,310,7.1
28113,2016,14681,13689,992,6.8
28115,2016,14446,13766,680,4.7
28117,2016,11069,10468,601,5.4
28119,2016,2618,2364,254,9.699999999999999
28121,2016,74995,72044,2951,3.9
28123,2016,13271,12665,606,4.6
28125,2016,1715,1565,150,8.699999999999999
28127,2016,10939,10347,592,5.4
28129,2016,6742,6389,353,5.2
28131,2016,6497,6062,435,6.7
28133,2016,8344,7572,772,9.300000000000001
28135,2016,5740,5352,388,6.8
28137,2016,12089,11385,704,5.8
28139,2016,9403,8883,520,5.5
28141,2016,8261,7810,451,5.5
28143,2016,4611,4285,326,7.1
28145,2016,13668,13067,601,4.4
28147,2016,5039,4652,387,7.7
28149,2016,20820,19508,1312,6.3
28151,2016,17768,16177,1591,9
28153,2016,7540,6991,549,7.3
28155,2016,3907,3665,242,6.2
28157,2016,2836,2549,287,10.1
28159,2016,7110,6608,502,7.1
28161,2016,4889,4584,305,6.2
28163,2016,9252,8572,680,7.3
29001,2016,10388,9798,590,5.7
29003,2016,10048,9674,374,3.7
29005,2016,2846,2716,130,4.6
29007,2016,11151,10677,474,4.3
29009,2016,15217,14533,684,4.5
29011,2016,5328,5049,279,5.2
29013,2016,8169,7732,437,5.3
29015,2016,7268,6828,440,6.1
29017,2016,5469,5182,287,5.2
29019,2016,98313,95073,3240,3.3
29021,2016,46769,44857,1912,4.1
29023,2016,18826,17748,1078,5.7
29025,2016,4481,4270,211,4.7
29027,2016,21860,20962,898,4.1
29029,2016,18751,17664,1087,5.8
29031,2016,40824,39053,1771,4.3
29033,2016,4776,4519,257,5.4
29035,2016,2547,2366,181,7.1
29037,2016,54599,52331,2268,4.2
29039,2016,5806,5516,290,5
29041,2016,3862,3694,168,4.4
29043,2016,43426,41721,1705,3.9
29045,2016,3375,3127,248,7.3
29047,2016,134218,128981,5237,3.9
29049,2016,11029,10563,466,4.2
29051,2016,39488,38081,1407,3.6
29053,2016,7494,7125,369,4.9
29055,2016,10846,10266,580,5.3
29057,2016,3591,3431,160,4.5
29059,2016,6967,6584,383,5.5
29061,2016,4122,3963,159,3.9
29063,2016,5092,4869,223,4.4
29065,2016,6213,5878,335,5.4
29067,2016,5089,4780,309,6.1
29069,2016,12857,11798,1059,8.199999999999999
29071,2016,52756,50453,2303,4.4
29073,2016,7712,7380,332,4.3
29075,2016,3594,3460,134,3.7
29077,2016,148822,143173,5649,3.8
29079,2016,4910,4686,224,4.6
29081,2016,3979,3811,168,4.2
29083,2016,9907,9412,495,5
29085,2016,3701,3493,208,5.6
29087,2016,2689,2602,87,3.2
29089,2016,5038,4815,223,4.4
29091,2016,16143,15118,1025,6.3
29093,2016,3721,3454,267,7.2
29095,2016,364782,346091,18691,5.1
29097,2016,57829,55422,2407,4.2
29099,2016,117823,112753,5070,4.3
29101,2016,23221,22081,1140,4.9
29103,2016,1987,1915,72,3.6
29105,2016,16186,15303,883,5.5
29107,2016,17219,16476,743,4.3
29109,2016,17815,17036,779,4.4
29111,2016,5146,4913,233,4.5
29113,2016,27271,26047,1224,4.5
29115,2016,5282,4927,355,6.7
29117,2016,7362,7074,288,3.9
29119,2016,10492,10036,456,4.3
29121,2016,7626,7262,364,4.8
29123,2016,5487,5185,302,5.5
29125,2016,3916,3719,197,5
29127,2016,14597,13972,625,4.3
29129,2016,1932,1843,89,4.6
29131,2016,11902,11286,616,5.2
29133,2016,6225,5812,413,6.6
29135,2016,7483,7158,325,4.3
29137,2016,4169,3967,202,4.8
29139,2016,5758,5495,263,4.6
29141,2016,7980,7511,469,5.9
29143,2016,8256,7488,768,9.300000000000001
29145,2016,28266,27031,1235,4.4
29147,2016,10869,10361,508,4.7
29149,2016,4121,3874,247,6
29151,2016,7238,6992,246,3.4
29153,2016,3636,3372,264,7.3
29155,2016,7044,6418,626,8.9
29157,2016,10095,9735,360,3.6
29159,2016,20659,19639,1020,4.9
29161,2016,19539,18610,929,4.8
29163,2016,8078,7714,364,4.5
29165,2016,56800,54742,2058,3.6
29167,2016,14245,13551,694,4.9
29169,2016,14501,13713,788,5.4
29171,2016,2458,2346,112,4.6
29173,2016,5636,5409,227,4
29175,2016,10511,9959,552,5.3
29177,2016,11165,10615,550,4.9
29179,2016,2687,2513,174,6.5
29181,2016,5345,4967,378,7.1
29183,2016,221494,213718,7776,3.5
29185,2016,3923,3677,246,6.3
29186,2016,9004,8585,419,4.7
29187,2016,26283,24834,1449,5.5
29189,2016,532537,510089,22448,4.2
29195,2016,10756,10254,502,4.7
29197,2016,1909,1788,121,6.3
29199,2016,2459,2357,102,4.1
29201,2016,20005,18859,1146,5.7
29203,2016,3332,3087,245,7.4
29205,2016,3076,2947,129,4.2
29207,2016,13321,12468,853,6.4
29209,2016,13449,12509,940,7
29211,2016,2776,2616,160,5.8
29213,2016,26370,24422,1948,7.4
29215,2016,9338,8753,585,6.3
29217,2016,9624,9157,467,4.9
29219,2016,17526,16793,733,4.2
29221,2016,10359,9702,657,6.3
29223,2016,5668,5365,303,5.3
29225,2016,16929,16096,833,4.9
29227,2016,1213,1177,36,3
29229,2016,7616,7165,451,5.9
29510,2016,157649,149054,8595,5.5
30001,2016,5077,4909,168,3.3
30003,2016,5540,5139,401,7.2
30005,2016,2372,2264,108,4.6
30007,2016,2553,2428,125,4.9
30009,2016,5426,5212,214,3.9
30011,2016,697,678,19,2.7
30013,2016,37838,36336,1502,4
30015,2016,2516,2422,94,3.7
30017,2016,6246,6026,220,3.5
30019,2016,936,912,24,2.6
30021,2016,4608,4431,177,3.8
30023,2016,5304,5103,201,3.8
30025,2016,1814,1748,66,3.6
30027,2016,5772,5545,227,3.9
30029,2016,46004,43436,2568,5.6
30031,2016,62187,60437,1750,2.8
30033,2016,765,743,22,2.9
30035,2016,5824,5327,497,8.5
30037,2016,379,362,17,4.5
30039,2016,1633,1537,96,5.9
30041,2016,7808,7471,337,4.3
30043,2016,5676,5415,261,4.6
30045,2016,934,902,32,3.4
30047,2016,13094,12474,620,4.7
30049,2016,35230,34067,1163,3.3
30051,2016,990,959,31,3.1
30053,2016,7938,7223,715,9
30055,2016,1044,1024,20,1.9
30057,2016,4418,4251,167,3.8
30059,2016,917,880,37,4
30061,2016,1688,1560,128,7.6
30063,2016,61457,59156,2301,3.7
30065,2016,2297,2179,118,5.1
30067,2016,8417,8057,360,4.3
30069,2016,278,265,13,4.7
30071,2016,1938,1835,103,5.3
30073,2016,2868,2747,121,4.2
30075,2016,1068,1043,25,2.3
30077,2016,2870,2726,144,5
30079,2016,527,509,18,3.4
30081,2016,19593,18653,940,4.8
30083,2016,6219,5911,308,5
30085,2016,4692,4442,250,5.3
30087,2016,4111,3886,225,5.5
30089,2016,4759,4391,368,7.7
30091,2016,1962,1898,64,3.3
30093,2016,17208,16472,736,4.3
30095,2016,4815,4624,191,4
30097,2016,1799,1743,56,3.1
30099,2016,2832,2730,102,3.6
30101,2016,2228,2151,77,3.5
30103,2016,353,338,15,4.2
30105,2016,4408,4259,149,3.4
30107,2016,797,757,40,5
30109,2016,513,493,20,3.9
30111,2016,81264,78343,2921,3.6
31001,2016,16637,16116,521,3.1
31003,2016,3589,3495,94,2.6
31005,2016,227,214,13,5.7
31007,2016,416,402,14,3.4
31009,2016,264,253,11,4.2
31011,2016,3000,2921,79,2.6
31013,2016,5638,5435,203,3.6
31015,2016,1098,1065,33,3
31017,2016,1378,1328,50,3.6
31019,2016,27185,26504,681,2.5
31021,2016,3542,3412,130,3.7
31023,2016,4620,4472,148,3.2
31025,2016,13128,12687,441,3.4
31027,2016,4564,4448,116,2.5
31029,2016,2289,2242,47,2.1
31031,2016,3467,3389,78,2.2
31033,2016,5445,5292,153,2.8
31035,2016,3318,3215,103,3.1
31037,2016,5544,5387,157,2.8
31039,2016,4711,4575,136,2.9
31041,2016,6345,6196,149,2.3
31043,2016,10895,10443,452,4.1
31045,2016,5208,5054,154,3
31047,2016,12949,12566,383,3
31049,2016,1059,1032,27,2.5
31051,2016,3065,2964,101,3.3
31053,2016,19107,18521,586,3.1
31055,2016,287660,278127,9533,3.3
31057,2016,1194,1168,26,2.2
31059,2016,3180,3092,88,2.8
31061,2016,1499,1454,45,3
31063,2016,1568,1524,44,2.8
31065,2016,2711,2636,75,2.8
31067,2016,11036,10675,361,3.3
31069,2016,1186,1147,39,3.3
31071,2016,1154,1125,29,2.5
31073,2016,1055,1028,27,2.6
31075,2016,452,442,10,2.2
31077,2016,1232,1194,38,3.1
31079,2016,31371,30221,1150,3.7
31081,2016,4647,4518,129,2.8
31083,2016,1755,1711,44,2.5
31085,2016,589,575,14,2.4
31087,2016,1304,1257,47,3.6
31089,2016,5852,5708,144,2.5
31091,2016,391,377,14,3.6
31093,2016,3296,3187,109,3.3
31095,2016,4216,4115,101,2.4
31097,2016,2089,2023,66,3.2
31099,2016,3736,3648,88,2.4
31101,2016,4611,4478,133,2.9
31103,2016,619,606,13,2.1
31105,2016,1969,1889,80,4.1
31107,2016,4714,4570,144,3.1
31109,2016,168830,164151,4679,2.8
31111,2016,18687,18113,574,3.1
31113,2016,483,469,14,2.9
31115,2016,396,382,14,3.5
31117,2016,463,452,11,2.4
31119,2016,19136,18610,526,2.7
31121,2016,4029,3884,145,3.6
31123,2016,2645,2561,84,3.2
31125,2016,1997,1942,55,2.8
31127,2016,3612,3481,131,3.6
31129,2016,2363,2295,68,2.9
31131,2016,8251,7971,280,3.4
31133,2016,1651,1614,37,2.2
31135,2016,1817,1778,39,2.1
31137,2016,4923,4800,123,2.5
31139,2016,4141,4032,109,2.6
31141,2016,16953,16364,589,3.5
31143,2016,2878,2802,76,2.6
31145,2016,5968,5800,168,2.8
31147,2016,4233,4096,137,3.2
31149,2016,890,867,23,2.6
31151,2016,7341,7115,226,3.1
31153,2016,91943,89269,2674,2.9
31155,2016,10860,10527,333,3.1
31157,2016,18821,18164,657,3.5
31159,2016,8743,8493,250,2.9
31161,2016,2735,2657,78,2.9
31163,2016,1715,1660,55,3.2
31165,2016,783,762,21,2.7
31167,2016,3437,3347,90,2.6
31169,2016,2900,2829,71,2.4
31171,2016,448,433,15,3.3
31173,2016,2976,2832,144,4.8
31175,2016,2089,2031,58,2.8
31177,2016,11093,10739,354,3.2
31179,2016,5617,5468,149,2.7
31181,2016,1711,1657,54,3.2
31183,2016,565,553,12,2.1
31185,2016,7314,7117,197,2.7
32001,2016,10385,9810,575,5.5
32003,2016,1048544,987517,61027,5.8
32005,2016,22243,20995,1248,5.6
32007,2016,26924,25724,1200,4.5
32009,2016,515,491,24,4.7
32011,2016,988,943,45,4.6
32013,2016,8052,7612,440,5.5
32015,2016,3130,2935,195,6.2
32017,2016,1985,1880,105,5.3
32019,2016,21267,19674,1593,7.5
32021,2016,2011,1883,128,6.4
32023,2016,16025,14852,1173,7.3
32027,2016,2458,2313,145,5.9
32029,2016,1906,1786,120,6.3
32031,2016,229817,218347,11470,5
32033,2016,4484,4276,208,4.6
32510,2016,24721,23222,1499,6.1
33001,2016,31386,30496,890,2.8
33003,2016,23672,22974,698,2.9
33005,2016,41402,40269,1133,2.7
33007,2016,14642,14090,552,3.8
33009,2016,48748,47596,1152,2.4
33011,2016,232001,224981,7020,3
33013,2016,81926,79835,2091,2.6
33015,2016,181713,176210,5503,3
33017,2016,72417,70572,1845,2.5
33019,2016,23593,23044,549,2.3
34001,2016,122411,113320,9091,7.4
34003,2016,478906,458863,20043,4.2
34005,2016,229949,219677,10272,4.5
34007,2016,252368,238479,13889,5.5
34009,2016,46601,42016,4585,9.800000000000001
34011,2016,66246,61285,4961,7.5
34013,2016,368262,346140,22122,6
34015,2016,148764,141227,7537,5.1
34017,2016,359225,342429,16796,4.7
34019,2016,64277,61855,2422,3.8
34021,2016,198103,189516,8587,4.3
34023,2016,435237,415904,19333,4.4
34025,2016,325773,311239,14534,4.5
34027,2016,258177,248057,10120,3.9
34029,2016,267316,253333,13983,5.2
34031,2016,243597,228552,15045,6.2
34033,2016,29970,28051,1919,6.4
34035,2016,172080,165098,6982,4.1
34037,2016,74843,71312,3531,4.7
34039,2016,275373,261137,14236,5.2
34041,2016,56302,53719,2583,4.6
35001,2016,326722,307963,18759,5.7
35003,2016,1204,1108,96,8
35005,2016,28031,26172,1859,6.6
35006,2016,9300,8546,754,8.1
35007,2016,5828,5482,346,5.9
35009,2016,21969,20872,1097,5
35011,2016,833,794,39,4.7
35013,2016,95598,88827,6771,7.1
35015,2016,28685,26843,1842,6.4
35017,2016,12460,11666,794,6.4
35019,2016,1691,1583,108,6.4
35021,2016,277,258,19,6.9
35023,2016,2202,2082,120,5.4
35025,2016,27727,25200,2527,9.1
35027,2016,8641,8133,508,5.9
35028,2016,8797,8429,368,4.2
35029,2016,10771,9225,1546,14.4
35031,2016,24375,22120,2255,9.300000000000001
35033,2016,2237,2044,193,8.6
35035,2016,25473,23949,1524,6
35037,2016,3210,2994,216,6.7
35039,2016,16756,15519,1237,7.4
35041,2016,8068,7613,455,5.6
35043,2016,64093,59921,4172,6.5
35045,2016,54211,49510,4701,8.699999999999999
35047,2016,11088,10245,843,7.6
35049,2016,73496,69657,3839,5.2
35051,2016,4060,3721,339,8.300000000000001
35053,2016,6678,6194,484,7.2
35055,2016,14937,13694,1243,8.300000000000001
35057,2016,5506,5010,496,9
35059,2016,1894,1819,75,4
35061,2016,29911,27781,2130,7.1
36001,2016,158435,152009,6426,4.1
36003,2016,20052,18786,1266,6.3
36005,2016,607295,563965,43330,7.1
36007,2016,85851,81196,4655,5.4
36009,2016,34849,32768,2081,6
36011,2016,36691,34836,1855,5.1
36013,2016,56113,52857,3256,5.8
36015,2016,36202,34131,2071,5.7
36017,2016,22829,21673,1156,5.1
36019,2016,35795,33877,1918,5.4
36021,2016,31460,30301,1159,3.7
36023,2016,22982,21673,1309,5.7
36025,2016,19220,18159,1061,5.5
36027,2016,143032,137076,5956,4.2
36029,2016,445070,423157,21913,4.9
36031,2016,17235,16315,920,5.3
36033,2016,19788,18666,1122,5.7
36035,2016,23219,21891,1328,5.7
36037,2016,29726,28363,1363,4.6
36039,2016,20559,19521,1038,5
36041,2016,2363,2210,153,6.5
36043,2016,28164,26626,1538,5.5
36045,2016,45649,42804,2845,6.2
36047,2016,1214539,1149735,64804,5.3
36049,2016,11739,10951,788,6.7
36051,2016,31030,29498,1532,4.9
36053,2016,32694,30973,1721,5.3
36055,2016,363191,346126,17065,4.7
36057,2016,22302,21027,1275,5.7
36059,2016,699796,672454,27342,3.9
36061,2016,914469,872736,41733,4.6
36063,2016,100198,94366,5832,5.8
36065,2016,101631,96711,4920,4.8
36067,2016,221119,211142,9977,4.5
36069,2016,55054,52680,2374,4.3
36071,2016,178863,171135,7728,4.3
36073,2016,17745,16731,1014,5.7
36075,2016,53286,49847,3439,6.5
36077,2016,28197,26812,1385,4.9
36079,2016,50674,48657,2017,4
36081,2016,1158611,1105906,52705,4.5
36083,2016,81541,78055,3486,4.3
36085,2016,220823,209238,11585,5.2
36087,2016,152479,146098,6381,4.2
36089,2016,43346,40489,2857,6.6
36091,2016,117440,112961,4479,3.8
36093,2016,75764,72482,3282,4.3
36095,2016,14720,13921,799,5.4
36097,2016,8275,7777,498,6
36099,2016,15484,14747,737,4.8
36101,2016,43152,40638,2514,5.8
36103,2016,773871,740123,33748,4.4
36105,2016,34025,32399,1626,4.8
36107,2016,23010,21829,1181,5.1
36109,2016,50351,48257,2094,4.2
36111,2016,88138,84242,3896,4.4
36113,2016,31980,30298,1682,5.3
36115,2016,28335,27018,1317,4.6
36117,2016,43980,41789,2191,5
36119,2016,477692,457221,20471,4.3
36121,2016,18102,17137,965,5.3
36123,2016,11713,11196,517,4.4
37001,2016,78943,75209,3734,4.7
37003,2016,17835,17078,757,4.2
37005,2016,4426,4183,243,5.5
37007,2016,10660,10043,617,5.8
37009,2016,12508,11909,599,4.8
37011,2016,7576,7195,381,5
37013,2016,20307,19153,1154,5.7
37015,2016,8436,7879,557,6.6
37017,2016,14569,13564,1005,6.9
37019,2016,49705,46504,3201,6.4
37021,2016,134374,129188,5186,3.9
37023,2016,39858,37921,1937,4.9
37025,2016,101184,96569,4615,4.6
37027,2016,35899,34039,1860,5.2
37029,2016,4659,4419,240,5.2
37031,2016,31574,29947,1627,5.2
37033,2016,9690,9164,526,5.4
37035,2016,76890,73255,3635,4.7
37037,2016,34527,33065,1462,4.2
37039,2016,11146,10514,632,5.7
37041,2016,5602,5244,358,6.4
37043,2016,4051,3830,221,5.5
37045,2016,46815,44259,2556,5.5
37047,2016,22596,21149,1447,6.4
37049,2016,41759,39576,2183,5.2
37051,2016,127339,119205,8134,6.4
37053,2016,13153,12487,666,5.1
37055,2016,20004,18654,1350,6.7
37057,2016,79516,75690,3826,4.8
37059,2016,20172,19265,907,4.5
37061,2016,26506,25094,1412,5.3
37063,2016,162115,154825,7290,4.5
37065,2016,22421,20478,1943,8.699999999999999
37067,2016,182652,173776,8876,4.9
37069,2016,29347,27816,1531,5.2
37071,2016,105652,100025,5627,5.3
37073,2016,5191,4925,266,5.1
37075,2016,3102,2828,274,8.800000000000001
37077,2016,29283,28019,1264,4.3
37079,2016,9524,9021,503,5.3
37081,2016,258484,244973,13511,5.2
37083,2016,20684,19047,1637,7.9
37085,2016,51461,48486,2975,5.8
37087,2016,28486,27193,1293,4.5
37089,2016,52299,50072,2227,4.3
37091,2016,9316,8704,612,6.6
37093,2016,19916,18605,1311,6.6
37095,2016,2110,1910,200,9.5
37097,2016,84565,80506,4059,4.8
37099,2016,18831,17809,1022,5.4
37101,2016,91592,87311,4281,4.7
37103,2016,4515,4277,238,5.3
37105,2016,26231,24691,1540,5.9
37107,2016,27651,26032,1619,5.9
37109,2016,41095,39160,1935,4.7
37111,2016,21015,20008,1007,4.8
37113,2016,15219,14400,819,5.4
37115,2016,9702,9230,472,4.9
37117,2016,9814,9152,662,6.7
37119,2016,583478,555878,27600,4.7
37121,2016,6188,5810,378,6.1
37123,2016,11700,11097,603,5.2
37125,2016,39513,37533,1980,5
37127,2016,43928,41043,2885,6.6
37129,2016,116055,110586,5469,4.7
37131,2016,7816,7249,567,7.3
37133,2016,63719,60214,3505,5.5
37135,2016,74933,71765,3168,4.2
37137,2016,5408,5123,285,5.3
37139,2016,17397,16305,1092,6.3
37141,2016,26852,25433,1419,5.3
37143,2016,5101,4773,328,6.4
37145,2016,18036,17048,988,5.5
37147,2016,88213,83304,4909,5.6
37149,2016,8825,8416,409,4.6
37151,2016,66894,63603,3291,4.9
37153,2016,16790,15630,1160,6.9
37155,2016,50549,46545,4004,7.9
37157,2016,40854,38549,2305,5.6
37159,2016,64233,60664,3569,5.6
37161,2016,24811,23153,1658,6.7
37163,2016,29517,27908,1609,5.5
37165,2016,11635,10574,1061,9.1
37167,2016,29288,27931,1357,4.6
37169,2016,21874,20830,1044,4.8
37171,2016,33524,31924,1600,4.8
37173,2016,7118,6684,434,6.1
37175,2016,13959,13280,679,4.9
37177,2016,1530,1401,129,8.4
37179,2016,115773,110681,5092,4.4
37181,2016,18004,16718,1286,7.1
37183,2016,556706,532827,23879,4.3
37185,2016,7143,6622,521,7.3
37187,2016,4865,4505,360,7.4
37189,2016,27949,26695,1254,4.5
37191,2016,53556,50438,3118,5.8
37193,2016,30204,28759,1445,4.8
37195,2016,36486,33517,2969,8.1
37197,2016,17612,16841,771,4.4
37199,2016,7478,7093,385,5.1
38001,2016,1132,1103,29,2.6
38003,2016,5619,5440,179,3.2
38005,2016,2434,2336,98,4
38007,2016,438,425,13,3
38009,2016,3227,3077,150,4.6
38011,2016,1835,1796,39,2.1
38013,2016,1145,1093,52,4.5
38015,2016,50602,49297,1305,2.6
38017,2016,100165,97926,2239,2.2
38019,2016,2115,2059,56,2.6
38021,2016,2545,2496,49,1.9
38023,2016,1683,1639,44,2.6
38025,2016,3247,3145,102,3.1
38027,2016,1278,1223,55,4.3
38029,2016,1584,1515,69,4.4
38031,2016,1685,1635,50,3
38033,2016,971,945,26,2.7
38035,2016,38797,37883,914,2.4
38037,2016,1296,1257,39,3
38039,2016,1159,1126,33,2.8
38041,2016,1539,1493,46,3
38043,2016,1375,1323,52,3.8
38045,2016,2314,2259,55,2.4
38047,2016,960,926,34,3.5
38049,2016,3374,3209,165,4.9
38051,2016,1240,1202,38,3.1
38053,2016,7943,7644,299,3.8
38055,2016,5066,4890,176,3.5
38057,2016,4651,4447,204,4.4
38059,2016,16786,16239,547,3.3
38061,2016,7128,6916,212,3
38063,2016,1533,1481,52,3.4
38065,2016,898,849,49,5.5
38067,2016,3658,3475,183,5
38069,2016,1897,1822,75,4
38071,2016,6143,5968,175,2.8
38073,2016,2838,2774,64,2.3
38075,2016,1307,1257,50,3.8
38077,2016,8899,8655,244,2.7
38079,2016,4983,4444,539,10.8
38081,2016,2331,2286,45,1.9
38083,2016,737,695,42,5.7
38085,2016,1338,1279,59,4.4
38087,2016,436,425,11,2.5
38089,2016,18076,17370,706,3.9
38091,2016,1074,1051,23,2.1
38093,2016,11073,10800,273,2.5
38095,2016,1332,1302,30,2.3
38097,2016,4597,4469,128,2.8
38099,2016,5659,5445,214,3.8
38101,2016,33522,32142,1380,4.1
38103,2016,2190,2105,85,3.9
38105,2016,22621,21636,985,4.4
39001,2016,10939,10112,827,7.6
39003,2016,48242,45808,2434,5
39005,2016,26250,24910,1340,5.1
39007,2016,44206,41494,2712,6.1
39009,2016,28008,26205,1803,6.4
39011,2016,24610,23687,923,3.8
39013,2016,31000,28674,2326,7.5
39015,2016,19485,18350,1135,5.8
39017,2016,189364,180784,8580,4.5
39019,2016,13432,12508,924,6.9
39021,2016,19874,18974,900,4.5
39023,2016,63553,60203,3350,5.3
39025,2016,103866,99226,4640,4.5
39027,2016,17163,16158,1005,5.9
39029,2016,48366,45115,3251,6.7
39031,2016,14989,13920,1069,7.1
39033,2016,19163,18001,1162,6.1
39035,2016,617505,583926,33579,5.4
39037,2016,26364,25272,1092,4.1
39039,2016,18373,17461,912,5
39041,2016,104813,101003,3810,3.6
39043,2016,37409,35341,2068,5.5
39045,2016,75927,72627,3300,4.3
39047,2016,14482,13836,646,4.5
39049,2016,666583,638923,27660,4.1
39051,2016,22668,21607,1061,4.7
39053,2016,12122,11291,831,6.9
39055,2016,49486,47319,2167,4.4
39057,2016,81065,77519,3546,4.4
39059,2016,18883,17538,1345,7.1
39061,2016,404791,386761,18030,4.5
39063,2016,41446,39908,1538,3.7
39065,2016,14372,13650,722,5
39067,2016,6967,6432,535,7.7
39069,2016,13600,12869,731,5.4
39071,2016,16924,15845,1079,6.4
39073,2016,13005,12275,730,5.6
39075,2016,20983,20222,761,3.6
39077,2016,28107,26267,1840,6.5
39079,2016,12797,11786,1011,7.9
39081,2016,28897,26469,2428,8.4
39083,2016,31219,29766,1453,4.7
39085,2016,125662,119629,6033,4.8
39087,2016,24743,23123,1620,6.5
39089,2016,88215,84323,3892,4.4
39091,2016,23313,22330,983,4.2
39093,2016,153570,144544,9026,5.9
39095,2016,210347,199375,10972,5.2
39097,2016,20329,19524,805,4
39099,2016,105917,99115,6802,6.4
39101,2016,27729,26312,1417,5.1
39103,2016,96746,92570,4176,4.3
39105,2016,8951,8183,768,8.6
39107,2016,23415,22645,770,3.3
39109,2016,52992,50669,2323,4.4
39111,2016,5319,4724,595,11.2
39113,2016,249967,237552,12415,5
39115,2016,6751,6188,563,8.300000000000001
39117,2016,16761,15909,852,5.1
39119,2016,39724,37314,2410,6.1
39121,2016,4891,4462,429,8.800000000000001
39123,2016,21024,19659,1365,6.5
39125,2016,8872,8462,410,4.6
39127,2016,15885,14866,1019,6.4
39129,2016,26194,24921,1273,4.9
39131,2016,10804,9988,816,7.6
39133,2016,87094,82692,4402,5.1
39135,2016,21012,20004,1008,4.8
39137,2016,18893,18197,696,3.7
39139,2016,53393,50416,2977,5.6
39141,2016,33827,31950,1877,5.5
39143,2016,31014,29541,1473,4.7
39145,2016,29868,27543,2325,7.8
39147,2016,27140,25803,1337,4.9
39149,2016,24064,23059,1005,4.2
39151,2016,186400,176173,10227,5.5
39153,2016,272310,258318,13992,5.1
39155,2016,90400,84249,6151,6.8
39157,2016,45004,42402,2602,5.8
39159,2016,27783,26715,1068,3.8
39161,2016,14300,13718,582,4.1
39163,2016,5453,5066,387,7.1
39165,2016,114558,109770,4788,4.2
39167,2016,27769,25819,1950,7
39169,2016,61196,58742,2454,4
39171,2016,19018,18154,864,4.5
39173,2016,70624,67655,2969,4.2
39175,2016,12669,12196,473,3.7
40001,2016,8160,7685,475,5.8
40003,2016,2969,2871,98,3.3
40005,2016,5065,4733,332,6.6
40007,2016,2889,2799,90,3.1
40009,2016,11042,10249,793,7.2
40011,2016,4395,4233,162,3.7
40013,2016,19525,18686,839,4.3
40015,2016,11934,11302,632,5.3
40017,2016,69467,66703,2764,4
40019,2016,22738,21563,1175,5.2
40021,2016,19302,18242,1060,5.5
40023,2016,5760,5321,439,7.6
40025,2016,1417,1382,35,2.5
40027,2016,139263,133954,5309,3.8
40029,2016,2323,2153,170,7.3
40031,2016,49487,47211,2276,4.6
40033,2016,2892,2754,138,4.8
40035,2016,6258,5956,302,4.8
40037,2016,31526,29697,1829,5.8
40039,2016,15210,14519,691,4.5
40041,2016,17984,17105,879,4.9
40043,2016,2677,2569,108,4
40045,2016,2257,2171,86,3.8
40047,2016,29021,27756,1265,4.4
40049,2016,12725,12046,679,5.3
40051,2016,26113,24818,1295,5
40053,2016,3007,2911,96,3.2
40055,2016,2192,2030,162,7.4
40057,2016,1293,1244,49,3.8
40059,2016,1911,1838,73,3.8
40061,2016,4507,4135,372,8.300000000000001
40063,2016,5519,5119,400,7.2
40065,2016,11012,10529,483,4.4
40067,2016,2712,2519,193,7.1
40069,2016,4377,4121,256,5.8
40071,2016,18961,17766,1195,6.3
40073,2016,8457,8177,280,3.3
40075,2016,4113,3894,219,5.3
40077,2016,3728,3407,321,8.6
40079,2016,19773,18411,1362,6.9
40081,2016,15893,15049,844,5.3
40083,2016,21595,20723,872,4
40085,2016,6577,6370,207,3.1
40087,2016,18976,18197,779,4.1
40089,2016,14822,13764,1058,7.1
40091,2016,7066,6437,629,8.9
40093,2016,3997,3833,164,4.1
40095,2016,6621,6287,334,5
40097,2016,19460,18470,990,5.1
40099,2016,6350,6064,286,4.5
40101,2016,29656,28042,1614,5.4
40103,2016,5766,5562,204,3.5
40105,2016,4692,4406,286,6.1
40107,2016,4557,4280,277,6.1
40109,2016,375442,359374,16068,4.3
40111,2016,16169,15010,1159,7.2
40113,2016,21089,19877,1212,5.7
40115,2016,14480,13754,726,5
40117,2016,7498,7002,496,6.6
40119,2016,38944,37500,1444,3.7
40121,2016,17648,16566,1082,6.1
40123,2016,18473,17722,751,4.1
40125,2016,33090,31563,1527,4.6
40127,2016,4880,4525,355,7.3
40129,2016,1813,1720,93,5.1
40131,2016,44925,42673,2252,5
40133,2016,9451,8798,653,6.9
40135,2016,16857,15804,1053,6.2
40137,2016,19042,17237,1805,9.5
40139,2016,9410,9092,318,3.4
40141,2016,3315,3168,147,4.4
40143,2016,318525,303683,14842,4.7
40145,2016,36649,34903,1746,4.8
40147,2016,23954,22786,1168,4.9
40149,2016,5326,4958,368,6.9
40151,2016,5224,5056,168,3.2
40153,2016,9526,8936,590,6.2
41001,2016,6951,6513,438,6.3
41003,2016,46783,44947,1836,3.9
41005,2016,212633,203367,9266,4.4
41007,2016,19017,18120,897,4.7
41009,2016,23612,22171,1441,6.1
41011,2016,26434,24745,1689,6.4
41013,2016,9341,8693,648,6.9
41015,2016,9043,8432,611,6.8
41017,2016,89853,85483,4370,4.9
41019,2016,45693,42826,2867,6.3
41021,2016,837,788,49,5.9
41023,2016,3108,2870,238,7.7
41025,2016,3423,3209,214,6.3
41027,2016,13906,13330,576,4.1
41029,2016,101378,95552,5826,5.7
41031,2016,9859,9207,652,6.6
41033,2016,34281,32061,2220,6.5
41035,2016,29222,27242,1980,6.8
41037,2016,3452,3232,220,6.4
41039,2016,178428,169361,9067,5.1
41041,2016,20893,19721,1172,5.6
41043,2016,56815,53574,3241,5.7
41045,2016,12475,11787,688,5.5
41047,2016,157354,149396,7958,5.1
41049,2016,5765,5485,280,4.9
41051,2016,443744,425011,18733,4.2
41053,2016,38318,36384,1934,5
41055,2016,894,853,41,4.6
41057,2016,11638,11066,572,4.9
41059,2016,36004,34084,1920,5.3
41061,2016,11973,11266,707,5.9
41063,2016,3315,3091,224,6.8
41065,2016,13687,13030,657,4.8
41067,2016,313325,300470,12855,4.1
41069,2016,686,657,29,4.2
41071,2016,53176,50733,2443,4.6
42001,2016,55378,53186,2192,4
42003,2016,647300,613814,33486,5.2
42005,2016,33078,30603,2475,7.5
42007,2016,85293,80021,5272,6.2
42009,2016,24043,22639,1404,5.8
42011,2016,213140,202560,10580,5
42013,2016,60828,57624,3204,5.3
42015,2016,30163,28196,1967,6.5
42017,2016,340728,325030,15698,4.6
42019,2016,98572,93599,4973,5
42021,2016,61318,57163,4155,6.8
42023,2016,2231,2067,164,7.4
42025,2016,31552,29674,1878,6
42027,2016,78909,75622,3287,4.2
42029,2016,280252,269412,10840,3.9
42031,2016,18020,16913,1107,6.1
42033,2016,36293,33655,2638,7.3
42035,2016,18547,17238,1309,7.1
42037,2016,33883,32012,1871,5.5
42039,2016,40485,38059,2426,6
42041,2016,130077,124806,5271,4.1
42043,2016,142071,135314,6757,4.8
42045,2016,294104,279800,14304,4.9
42047,2016,16326,15428,898,5.5
42049,2016,133534,124864,8670,6.5
42051,2016,58413,53690,4723,8.1
42053,2016,1890,1742,148,7.8
42055,2016,77466,73480,3986,5.1
42057,2016,7301,6841,460,6.3
42059,2016,17290,15954,1336,7.7
42061,2016,19656,18286,1370,7
42063,2016,40150,37234,2916,7.3
42065,2016,20694,19281,1413,6.8
42067,2016,12196,11544,652,5.3
42069,2016,106729,100704,6025,5.6
42071,2016,279731,268202,11529,4.1
42073,2016,41491,38709,2782,6.7
42075,2016,70557,67401,3156,4.5
42077,2016,188955,178878,10077,5.3
42079,2016,158671,148700,9971,6.3
42081,2016,58697,54813,3884,6.6
42083,2016,18484,17263,1221,6.6
42085,2016,52515,49387,3128,6
42087,2016,20798,19611,1187,5.7
42089,2016,81855,76753,5102,6.2
42091,2016,447250,428784,18466,4.1
42093,2016,9124,8735,389,4.3
42095,2016,158776,150594,8182,5.2
42097,2016,43937,41200,2737,6.2
42099,2016,24276,23158,1118,4.6
42101,2016,703114,655667,47447,6.7
42103,2016,24902,23317,1585,6.4
42105,2016,7378,6800,578,7.8
42107,2016,67544,63377,4167,6.2
42109,2016,20511,19552,959,4.7
42111,2016,34160,31711,2449,7.2
42113,2016,2840,2636,204,7.2
42115,2016,20859,19676,1183,5.7
42117,2016,19858,18446,1412,7.1
42119,2016,19774,18830,944,4.8
42121,2016,23703,21989,1714,7.2
42123,2016,19769,18688,1081,5.5
42125,2016,107218,100679,6539,6.1
42127,2016,22515,21225,1290,5.7
42129,2016,182739,172070,10669,5.8
42131,2016,14082,13209,873,6.2
42133,2016,234807,223986,10821,4.6
44001,2016,26132,24924,1208,4.6
44003,2016,90721,86433,4288,4.7
44005,2016,44233,42154,2079,4.7
44007,2016,323192,305351,17841,5.5
44009,2016,68898,65630,3268,4.7
45001,2016,10300,9734,566,5.5
45003,2016,74254,70528,3726,5
45005,2016,2666,2437,229,8.6
45007,2016,89049,84947,4102,4.6
45009,2016,5326,4843,483,9.1
45011,2016,8086,7487,599,7.4
45013,2016,72630,69147,3483,4.8
45015,2016,97155,92694,4461,4.6
45017,2016,6913,6484,429,6.2
45019,2016,202083,193793,8290,4.1
45021,2016,23572,22159,1413,6
45023,2016,13415,12446,969,7.2
45025,2016,21670,20585,1085,5
45027,2016,12741,11888,853,6.7
45029,2016,16783,15841,942,5.6
45031,2016,29960,28087,1873,6.3
45033,2016,12708,11845,863,6.8
45035,2016,73287,69918,3369,4.6
45037,2016,10565,9964,601,5.7
45039,2016,10014,9289,725,7.2
45041,2016,65488,62024,3464,5.3
45043,2016,25009,23303,1706,6.8
45045,2016,245926,235461,10465,4.3
45047,2016,31401,29770,1631,5.2
45049,2016,8243,7760,483,5.9
45051,2016,140424,132187,8237,5.9
45053,2016,12018,11492,526,4.4
45055,2016,29296,27761,1535,5.2
45057,2016,38406,36354,2052,5.3
45059,2016,30085,28512,1573,5.2
45061,2016,6450,5992,458,7.1
45063,2016,148313,142252,6061,4.1
45065,2016,3398,3208,190,5.6
45067,2016,12704,11592,1112,8.800000000000001
45069,2016,9329,8542,787,8.4
45071,2016,19222,18365,857,4.5
45073,2016,34279,32504,1775,5.2
45075,2016,35681,32503,3178,8.9
45077,2016,56452,53633,2819,5
45079,2016,200756,191043,9713,4.8
45081,2016,8910,8504,406,4.6
45083,2016,142621,135864,6757,4.7
45085,2016,44351,41734,2617,5.9
45087,2016,11487,10772,715,6.2
45089,2016,12497,11528,969,7.8
45091,2016,130876,124812,6064,4.6
46003,2016,1521,1487,34,2.2
46005,2016,9411,9168,243,2.6
46007,2016,1123,1079,44,3.9
46009,2016,2945,2865,80,2.7
46011,2016,18886,18369,517,2.7
46013,2016,21087,20524,563,2.7
46015,2016,2471,2408,63,2.5
46017,2016,726,666,60,8.300000000000001
46019,2016,5047,4873,174,3.4
46021,2016,850,825,25,2.9
46023,2016,3888,3764,124,3.2
46025,2016,1920,1845,75,3.9
46027,2016,6986,6777,209,3
46029,2016,15205,14737,468,3.1
46031,2016,1454,1389,65,4.5
46033,2016,3993,3833,160,4
46035,2016,11237,10968,269,2.4
46037,2016,2858,2737,121,4.2
46039,2016,2239,2130,109,4.9
46041,2016,2251,2049,202,9
46043,2016,1671,1629,42,2.5
46045,2016,2163,2113,50,2.3
46047,2016,3023,2891,132,4.4
46049,2016,1113,1084,29,2.6
46051,2016,4457,4314,143,3.2
46053,2016,2075,2013,62,3
46055,2016,1106,1079,27,2.4
46057,2016,3173,3067,106,3.3
46059,2016,1831,1792,39,2.1
46061,2016,1769,1709,60,3.4
46063,2016,761,739,22,2.9
46065,2016,10063,9825,238,2.4
46067,2016,3650,3557,93,2.5
46069,2016,698,679,19,2.7
46071,2016,1304,1250,54,4.1
46073,2016,1071,1045,26,2.4
46075,2016,569,556,13,2.3
46077,2016,2740,2668,72,2.6
46079,2016,6456,6237,219,3.4
46081,2016,13062,12632,430,3.3
46083,2016,31437,30760,677,2.2
46085,2016,1775,1692,83,4.7
46087,2016,3132,3055,77,2.5
46089,2016,1088,1051,37,3.4
46091,2016,2460,2365,95,3.9
46093,2016,13675,13246,429,3.1
46095,2016,770,738,32,4.2
46097,2016,1201,1169,32,2.7
46099,2016,107702,104943,2759,2.6
46101,2016,3949,3805,144,3.6
46102,2016,3611,3224,387,10.7
46103,2016,54706,53024,1682,3.1
46105,2016,1577,1532,45,2.9
46107,2016,1157,1126,31,2.7
46109,2016,4840,4640,200,4.1
46111,2016,1209,1173,36,3
46115,2016,3285,3184,101,3.1
46117,2016,1870,1825,45,2.4
46119,2016,859,839,20,2.3
46121,2016,3059,2862,197,6.4
46123,2016,3063,2995,68,2.2
46125,2016,4676,4546,130,2.8
46127,2016,8048,7798,250,3.1
46129,2016,2241,2126,115,5.1
46135,2016,11583,11286,297,2.6
46137,2016,976,932,44,4.5
47001,2016,33547,31921,1626,4.8
47003,2016,19752,18773,979,5
47005,2016,6714,6237,477,7.1
47007,2016,4306,4007,299,6.9
47009,2016,60618,57977,2641,4.4
47011,2016,49945,47725,2220,4.4
47013,2016,14680,13667,1013,6.9
47015,2016,5999,5722,277,4.6
47017,2016,11979,11176,803,6.7
47019,2016,23584,22255,1329,5.6
47021,2016,20188,19387,801,4
47023,2016,8415,7997,418,5
47025,2016,12652,11867,785,6.2
47027,2016,3031,2833,198,6.5
47029,2016,14398,13491,907,6.3
47031,2016,24364,23219,1145,4.7
47033,2016,6861,6503,358,5.2
47035,2016,23475,22088,1387,5.9
47037,2016,372624,359204,13420,3.6
47039,2016,4644,4325,319,6.9
47041,2016,7520,7103,417,5.5
47043,2016,24696,23623,1073,4.3
47045,2016,16307,15298,1009,6.2
47047,2016,18216,17301,915,5
47049,2016,7081,6645,436,6.2
47051,2016,19768,18811,957,4.8
47053,2016,21160,19924,1236,5.8
47055,2016,15219,14608,611,4
47057,2016,9252,8752,500,5.4
47059,2016,30763,29089,1674,5.4
47061,2016,4772,4464,308,6.5
47063,2016,26753,25390,1363,5.1
47065,2016,171297,163427,7870,4.6
47067,2016,2026,1866,160,7.9
47069,2016,9161,8599,562,6.1
47071,2016,10168,9562,606,6
47073,2016,23623,22352,1271,5.4
47075,2016,7649,7154,495,6.5
47077,2016,11944,11129,815,6.8
47079,2016,13873,13058,815,5.9
47081,2016,10398,9918,480,4.6
47083,2016,3186,2947,239,7.5
47085,2016,8611,8095,516,6
47087,2016,4476,4164,312,7
47089,2016,23529,22290,1239,5.3
47091,2016,7514,7154,360,4.8
47093,2016,232864,223589,9275,4
47095,2016,1908,1760,148,7.8
47097,2016,9400,8676,724,7.7
47099,2016,17731,16711,1020,5.8
47101,2016,4869,4581,288,5.9
47103,2016,15908,15258,650,4.1
47105,2016,22202,21168,1034,4.7
47107,2016,22679,21451,1228,5.4
47109,2016,8734,8122,612,7
47111,2016,10201,9757,444,4.4
47113,2016,47628,45317,2311,4.9
47115,2016,11878,11133,745,6.3
47117,2016,15020,14329,691,4.6
47119,2016,43933,42164,1769,4
47121,2016,4880,4548,332,6.8
47123,2016,19335,18317,1018,5.3
47125,2016,79683,75637,4046,5.1
47127,2016,3374,3247,127,3.8
47129,2016,7776,7276,500,6.4
47131,2016,12525,11645,880,7
47133,2016,9183,8693,490,5.3
47135,2016,3179,2978,201,6.3
47137,2016,2318,2165,153,6.6
47139,2016,7364,6943,421,5.7
47141,2016,33140,31521,1619,4.9
47143,2016,13426,12475,951,7.1
47145,2016,22780,21516,1264,5.5
47147,2016,34635,33199,1436,4.1
47149,2016,163069,157053,6016,3.7
47151,2016,7993,7403,590,7.4
47153,2016,5900,5557,343,5.8
47155,2016,51026,48508,2518,4.9
47157,2016,432665,409622,23043,5.3
47159,2016,8650,8255,395,4.6
47161,2016,5148,4800,348,6.8
47163,2016,69521,65937,3584,5.2
47165,2016,92013,88448,3565,3.9
47167,2016,27410,25857,1553,5.7
47169,2016,3833,3648,185,4.8
47171,2016,6987,6492,495,7.1
47173,2016,7254,6836,418,5.8
47175,2016,2030,1905,125,6.2
47177,2016,17612,16767,845,4.8
47179,2016,58537,55747,2790,4.8
47181,2016,6067,5669,398,6.6
47183,2016,15808,14886,922,5.8
47185,2016,11721,11139,582,5
47187,2016,113165,109311,3854,3.4
47189,2016,67595,64999,2596,3.8
48001,2016,23500,22484,1016,4.3
48003,2016,8686,8277,409,4.7
48005,2016,37048,34864,2184,5.9
48007,2016,10234,9663,571,5.6
48009,2016,4087,3911,176,4.3
48011,2016,934,908,26,2.8
48013,2016,21012,19892,1120,5.3
48015,2016,14024,13278,746,5.3
48017,2016,2717,2598,119,4.4
48019,2016,9499,9110,389,4.1
48021,2016,39014,37557,1457,3.7
48023,2016,1605,1547,58,3.6
48025,2016,10305,9531,774,7.5
48027,2016,139445,133173,6272,4.5
48029,2016,905115,871260,33855,3.7
48031,2016,5932,5749,183,3.1
48033,2016,366,353,13,3.6
48035,2016,8185,7833,352,4.3
48037,2016,39610,37749,1861,4.7
48039,2016,169795,161001,8794,5.2
48041,2016,111251,107409,3842,3.5
48043,2016,3960,3811,149,3.8
48045,2016,548,524,24,4.4
48047,2016,2438,2151,287,11.8
48049,2016,16164,15463,701,4.3
48051,2016,7872,7507,365,4.6
48053,2016,21986,21226,760,3.5
48055,2016,17936,17161,775,4.3
48057,2016,10771,10171,600,5.6
48059,2016,5804,5557,247,4.3
48061,2016,165955,154064,11891,7.2
48063,2016,5059,4714,345,6.8
48065,2016,3096,2995,101,3.3
48067,2016,12264,11384,880,7.2
48069,2016,3494,3387,107,3.1
48071,2016,18204,17098,1106,6.1
48073,2016,21190,20115,1075,5.1
48075,2016,2958,2870,88,3
48077,2016,4793,4584,209,4.4
48079,2016,1174,1114,60,5.1
48081,2016,1421,1362,59,4.2
48083,2016,3064,2886,178,5.8
48085,2016,512827,494723,18104,3.5
48087,2016,1215,1173,42,3.5
48089,2016,9790,9329,461,4.7
48091,2016,65468,63103,2365,3.6
48093,2016,5356,5126,230,4.3
48095,2016,1331,1286,45,3.4
48097,2016,18907,18158,749,4
48099,2016,24407,23269,1138,4.7
48101,2016,525,498,27,5.1
48103,2016,1705,1559,146,8.6
48105,2016,1735,1605,130,7.5
48107,2016,2620,2506,114,4.4
48109,2016,1000,959,41,4.1
48111,2016,3998,3909,89,2.2
48113,2016,1298058,1245964,52094,4
48115,2016,4638,4406,232,5
48117,2016,8606,8338,268,3.1
48119,2016,2606,2507,99,3.8
48121,2016,451787,436317,15470,3.4
48123,2016,9495,8977,518,5.5
48125,2016,691,657,34,4.9
48127,2016,6236,5792,444,7.1
48129,2016,1556,1493,63,4
48131,2016,4882,4349,533,10.9
48133,2016,7417,7014,403,5.4
48135,2016,76176,71340,4836,6.3
48137,2016,866,826,40,4.6
48139,2016,84956,81779,3177,3.7
48141,2016,349633,332375,17258,4.9
48143,2016,20224,19405,819,4
48145,2016,6607,6317,290,4.4
48147,2016,15760,15168,592,3.8
48149,2016,12485,12030,455,3.6
48151,2016,1758,1683,75,4.3
48153,2016,2736,2598,138,5
48155,2016,540,520,20,3.7
48157,2016,366735,348446,18289,5
48159,2016,4507,4287,220,4.9
48161,2016,6866,6408,458,6.7
48163,2016,8776,8350,426,4.9
48165,2016,9179,8838,341,3.7
48167,2016,160038,151521,8517,5.3
48169,2016,2129,2046,83,3.9
48171,2016,12991,12622,369,2.8
48173,2016,749,720,29,3.9
48175,2016,3316,3124,192,5.8
48177,2016,9567,9162,405,4.2
48179,2016,8481,7898,583,6.9
48181,2016,61180,58827,2353,3.8
48183,2016,58332,54789,3543,6.1
48185,2016,11048,10319,729,6.6
48187,2016,75931,73213,2718,3.6
48189,2016,12585,11879,706,5.6
48191,2016,1165,1087,78,6.7
48193,2016,3598,3422,176,4.9
48195,2016,2944,2852,92,3.1
48197,2016,1624,1560,64,3.9
48199,2016,25148,23620,1528,6.1
48201,2016,2249341,2129674,119667,5.3
48203,2016,29935,28140,1795,6
48205,2016,2959,2899,60,2
48207,2016,2508,2402,106,4.2
48209,2016,104838,101347,3491,3.3
48211,2016,2114,2035,79,3.7
48213,2016,35369,33718,1651,4.7
48215,2016,336926,310647,26279,7.8
48217,2016,15799,15104,695,4.4
48219,2016,11167,10649,518,4.6
48221,2016,25255,24070,1185,4.7
48223,2016,17317,16628,689,4
48225,2016,10058,9595,463,4.6
48227,2016,13207,12477,730,5.5
48229,2016,1541,1449,92,6
48231,2016,40499,38767,1732,4.3
48233,2016,9630,9089,541,5.6
48235,2016,780,755,25,3.2
48237,2016,3853,3663,190,4.9
48239,2016,7271,6932,339,4.7
48241,2016,13460,12429,1031,7.7
48243,2016,1072,1041,31,2.9
48245,2016,107450,99932,7518,7
48247,2016,1943,1758,185,9.5
48249,2016,17452,15614,1838,10.5
48251,2016,76008,72703,3305,4.3
48253,2016,5622,5297,325,5.8
48255,2016,6274,5968,306,4.9
48257,2016,57893,55704,2189,3.8
48259,2016,20338,19689,649,3.2
48261,2016,217,207,10,4.6
48263,2016,469,455,14,3
48265,2016,21349,20583,766,3.6
48267,2016,1951,1877,74,3.8
48269,2016,178,171,7,3.9
48271,2016,1156,1089,67,5.8
48273,2016,14103,13157,946,6.7
48275,2016,1558,1492,66,4.2
48277,2016,23219,22146,1073,4.6
48279,2016,5245,4905,340,6.5
48281,2016,9157,8777,380,4.1
48283,2016,3884,3685,199,5.1
48285,2016,8738,8370,368,4.2
48287,2016,9280,8930,350,3.8
48289,2016,6508,6087,421,6.5
48291,2016,31525,29156,2369,7.5
48293,2016,8322,7857,465,5.6
48295,2016,1651,1578,73,4.4
48297,2016,5201,4893,308,5.9
48299,2016,8289,7944,345,4.2
48301,2016,86,82,4,4.7
48303,2016,153504,148310,5194,3.4
48305,2016,2729,2621,108,4
48307,2016,3709,3543,166,4.5
48309,2016,116053,111471,4582,3.9
48311,2016,861,843,18,2.1
48313,2016,4766,4524,242,5.1
48315,2016,4340,4036,304,7
48317,2016,2481,2372,109,4.4
48319,2016,1790,1725,65,3.6
48321,2016,16874,15642,1232,7.3
48323,2016,24222,21505,2717,11.2
48325,2016,20982,20060,922,4.4
48327,2016,816,780,36,4.4
48329,2016,85010,81271,3739,4.4
48331,2016,10263,9735,528,5.1
48333,2016,1924,1844,80,4.2
48335,2016,2608,2425,183,7
48337,2016,9028,8582,446,4.9
48339,2016,265773,252769,13004,4.9
48341,2016,11188,10857,331,3
48343,2016,4891,4357,534,10.9
48345,2016,508,490,18,3.5
48347,2016,28697,27356,1341,4.7
48349,2016,22757,21807,950,4.2
48351,2016,5349,4926,423,7.9
48353,2016,6862,6533,329,4.8
48355,2016,167680,158247,9433,5.6
48357,2016,4660,4416,244,5.2
48359,2016,908,881,27,3
48361,2016,37334,34835,2499,6.7
48363,2016,13244,12522,722,5.5
48365,2016,10225,9493,732,7.2
48367,2016,61245,58758,2487,4.1
48369,2016,4946,4822,124,2.5
48371,2016,6493,6112,381,5.9
48373,2016,17372,16276,1096,6.3
48375,2016,56133,54257,1876,3.3
48377,2016,3078,2749,329,10.7
48379,2016,5551,5329,222,4
48381,2016,70631,68549,2082,2.9
48383,2016,1701,1596,105,6.2
48385,2016,1041,982,59,5.7
48387,2016,5031,4740,291,5.8
48389,2016,6031,5711,320,5.3
48391,2016,3134,2927,207,6.6
48393,2016,442,422,20,4.5
48395,2016,7253,6886,367,5.1
48397,2016,47329,45673,1656,3.5
48399,2016,4646,4463,183,3.9
48401,2016,22363,21062,1301,5.8
48403,2016,3481,3155,326,9.4
48405,2016,2802,2552,250,8.9
48407,2016,11421,10706,715,6.3
48409,2016,30594,28316,2278,7.4
48411,2016,2447,2364,83,3.4
48413,2016,1420,1346,74,5.2
48415,2016,7404,6969,435,5.9
48417,2016,1876,1804,72,3.8
48419,2016,10949,10293,656,6
48421,2016,1349,1310,39,2.9
48423,2016,105398,100638,4760,4.5
48425,2016,4130,3932,198,4.8
48427,2016,26333,22821,3512,13.3
48429,2016,4015,3804,211,5.3
48431,2016,669,643,26,3.9
48433,2016,640,612,28,4.4
48435,2016,1590,1464,126,7.9
48437,2016,2714,2599,115,4.2
48439,2016,1010694,970542,40152,4
48441,2016,63271,60908,2363,3.7
48443,2016,406,390,16,3.9
48445,2016,5348,5093,255,4.8
48447,2016,743,717,26,3.5
48449,2016,12872,12080,792,6.2
48451,2016,54228,51803,2425,4.5
48453,2016,677945,656425,21520,3.2
48455,2016,5480,5147,333,6.1
48457,2016,7210,6684,526,7.3
48459,2016,17887,16742,1145,6.4
48461,2016,1581,1497,84,5.3
48463,2016,11803,11177,626,5.3
48465,2016,20129,18874,1255,6.2
48467,2016,24842,23775,1067,4.3
48469,2016,43695,41329,2366,5.4
48471,2016,23774,22531,1243,5.2
48473,2016,22161,20925,1236,5.6
48475,2016,5392,5085,307,5.7
48477,2016,15076,14311,765,5.1
48479,2016,113792,108240,5552,4.9
48481,2016,21061,20004,1057,5
48483,2016,2481,2364,117,4.7
48485,2016,55437,53035,2402,4.3
48487,2016,5046,4809,237,4.7
48489,2016,6498,5703,795,12.2
48491,2016,278496,269165,9331,3.4
48493,2016,23741,22815,926,3.9
48495,2016,3068,2832,236,7.7
48497,2016,29413,28025,1388,4.7
48499,2016,17234,16328,906,5.3
48501,2016,3758,3579,179,4.8
48503,2016,8304,7941,363,4.4
48505,2016,5204,4645,559,10.7
48507,2016,3883,3345,538,13.9
49001,2016,3076,2924,152,4.9
49003,2016,24683,23821,862,3.5
49005,2016,61232,59361,1871,3.1
49007,2016,8334,7838,496,6
49009,2016,463,439,24,5.2
49011,2016,164341,159150,5191,3.2
49013,2016,8113,7391,722,8.9
49015,2016,4265,3998,267,6.3
49017,2016,2794,2561,233,8.300000000000001
49019,2016,5727,5390,337,5.9
49021,2016,21467,20531,936,4.4
49023,2016,5218,5028,190,3.6
49025,2016,3693,3552,141,3.8
49027,2016,6212,6005,207,3.3
49029,2016,5142,4989,153,3
49031,2016,458,431,27,5.9
49033,2016,1095,1060,35,3.2
49035,2016,601570,582448,19122,3.2
49037,2016,5742,5278,464,8.1
49039,2016,11799,11328,471,4
49041,2016,9589,9168,421,4.4
49043,2016,23873,23121,752,3.2
49045,2016,30826,29655,1171,3.8
49047,2016,14133,12814,1319,9.300000000000001
49049,2016,278913,270282,8631,3.1
49051,2016,13902,13431,471,3.4
49053,2016,67252,64738,2514,3.7
49055,2016,1428,1316,112,7.8
49057,2016,120114,115498,4616,3.8
50001,2016,20855,20237,618,3
50003,2016,18449,17756,693,3.8
50005,2016,14901,14284,617,4.1
50007,2016,95230,92854,2376,2.5
50009,2016,2700,2566,134,5
50011,2016,27357,26510,847,3.1
50013,2016,3975,3827,148,3.7
50015,2016,13922,13333,589,4.2
50017,2016,15900,15407,493,3.1
50019,2016,13537,12828,709,5.2
50021,2016,31460,30277,1183,3.8
50023,2016,33905,32826,1079,3.2
50025,2016,23221,22449,772,3.3
50027,2016,29331,28473,858,2.9
51001,2016,15783,15003,780,4.9
51003,2016,54381,52432,1949,3.6
51005,2016,6924,6568,356,5.1
51007,2016,6191,5925,266,4.3
51009,2016,14972,14310,662,4.4
51011,2016,6988,6658,330,4.7
51013,2016,146178,142317,3861,2.6
51015,2016,36795,35436,1359,3.7
51017,2016,2492,2399,93,3.7
51019,2016,37913,36349,1564,4.1
51021,2016,2736,2591,145,5.3
51023,2016,17326,16691,635,3.7
51025,2016,6203,5830,373,6
51027,2016,6854,6113,741,10.8
51029,2016,6259,5916,343,5.5
51031,2016,25906,24746,1160,4.5
51033,2016,14839,14170,669,4.5
51035,2016,12946,12274,672,5.2
51036,2016,3716,3545,171,4.6
51037,2016,5246,4981,265,5.1
51041,2016,180485,173447,7038,3.9
51043,2016,7424,7156,268,3.6
51045,2016,2347,2234,113,4.8
51047,2016,23416,22499,917,3.9
51049,2016,4598,4384,214,4.7
51051,2016,4570,4112,458,10
51053,2016,13428,12767,661,4.9
51057,2016,5517,5247,270,4.9
51059,2016,615904,595834,20070,3.3
51061,2016,35876,34614,1262,3.5
51063,2016,8179,7843,336,4.1
51065,2016,13164,12716,448,3.4
51067,2016,26333,25192,1141,4.3
51069,2016,45277,43677,1600,3.5
51071,2016,7932,7502,430,5.4
51073,2016,19064,18360,704,3.7
51075,2016,10815,10403,412,3.8
51077,2016,7014,6652,362,5.2
51079,2016,9918,9590,328,3.3
51081,2016,4202,3987,215,5.1
51083,2016,14848,13973,875,5.9
51085,2016,57094,55071,2023,3.5
51087,2016,178604,171571,7033,3.9
51089,2016,22114,20866,1248,5.6
51091,2016,1306,1264,42,3.2
51093,2016,18905,18082,823,4.4
51095,2016,34816,33453,1363,3.9
51097,2016,3655,3501,154,4.2
51099,2016,12304,11772,532,4.3
51101,2016,8738,8403,335,3.8
51103,2016,5103,4813,290,5.7
51105,2016,8435,7856,579,6.9
51107,2016,207000,200319,6681,3.2
51109,2016,18543,17827,716,3.9
51111,2016,5245,5001,244,4.7
51113,2016,7162,6936,226,3.2
51115,2016,4034,3871,163,4
51117,2016,12445,11738,707,5.7
51119,2016,5021,4827,194,3.9
51121,2016,49664,47588,2076,4.2
51125,2016,7226,6963,263,3.6
51127,2016,11656,11257,399,3.4
51131,2016,5869,5525,344,5.9
51133,2016,5442,5142,300,5.5
51135,2016,7026,6743,283,4
51137,2016,16341,15670,671,4.1
51139,2016,11581,10930,651,5.6
51141,2016,7943,7554,389,4.9
51143,2016,29660,28236,1424,4.8
51145,2016,13618,13130,488,3.6
51147,2016,10142,9596,546,5.4
51149,2016,14913,14180,733,4.9
51153,2016,234634,225991,8643,3.7
51155,2016,16252,15273,979,6
51157,2016,3706,3574,132,3.6
51159,2016,3903,3757,146,3.7
51161,2016,49068,47296,1772,3.6
51163,2016,10448,9986,462,4.4
51165,2016,40502,39064,1438,3.6
51167,2016,11231,10498,733,6.5
51169,2016,9413,8948,465,4.9
51171,2016,20799,20008,791,3.8
51173,2016,13661,12860,801,5.9
51175,2016,9024,8666,358,4
51177,2016,64856,62177,2679,4.1
51179,2016,68200,65501,2699,4
51181,2016,3652,3458,194,5.3
51183,2016,3944,3694,250,6.3
51185,2016,15938,14731,1207,7.6
51187,2016,19672,18868,804,4.1
51191,2016,26812,25590,1222,4.6
51193,2016,8967,8552,415,4.6
51195,2016,13192,12063,1129,8.6
51197,2016,13642,12856,786,5.8
51199,2016,32068,30810,1258,3.9
51510,2016,96248,93422,2826,2.9
51520,2016,7439,7058,381,5.1
51530,2016,3272,3104,168,5.1
51540,2016,24844,23997,847,3.4
51550,2016,117782,112696,5086,4.3
51570,2016,8700,8306,394,4.5
51580,2016,2380,2239,141,5.9
51590,2016,19085,17916,1169,6.1
51595,2016,2242,2096,146,6.5
51600,2016,12954,12554,400,3.1
51610,2016,7968,7748,220,2.8
51620,2016,3533,3317,216,6.1
51630,2016,13542,12887,655,4.8
51640,2016,2899,2754,145,5
51650,2016,63889,60210,3679,5.8
51660,2016,24199,23019,1180,4.9
51670,2016,9766,9122,644,6.6
51678,2016,2262,2122,140,6.2
51680,2016,35473,33610,1863,5.3
51683,2016,21566,20779,787,3.6
51685,2016,8469,8157,312,3.7
51690,2016,5157,4789,368,7.1
51700,2016,88729,84133,4596,5.2
51710,2016,110210,104327,5883,5.3
51720,2016,1659,1544,115,6.9
51730,2016,13193,12148,1045,7.9
51735,2016,6158,5940,218,3.5
51740,2016,44012,41279,2733,6.2
51750,2016,8248,7797,451,5.5
51760,2016,114514,109135,5379,4.7
51770,2016,48871,46746,2125,4.3
51775,2016,12874,12362,512,4
51790,2016,11776,11311,465,3.9
51800,2016,42908,40875,2033,4.7
51810,2016,228905,219741,9164,4
51820,2016,10178,9751,427,4.2
51830,2016,6705,6330,375,5.6
51840,2016,14305,13727,578,4
53001,2016,8700,8137,563,6.5
53003,2016,9944,9448,496,5
53005,2016,94130,88182,5948,6.3
53007,2016,43215,40734,2481,5.7
53009,2016,27270,25193,2077,7.6
53011,2016,220404,206972,13432,6.1
53013,2016,1716,1604,112,6.5
53015,2016,44769,41559,3210,7.2
53017,2016,20504,19087,1417,6.9
53019,2016,2489,2231,258,10.4
53021,2016,39787,36820,2967,7.5
53023,2016,918,864,54,5.9
53025,2016,44501,41314,3187,7.2
53027,2016,27197,24927,2270,8.300000000000001
53029,2016,32678,30747,1931,5.9
53031,2016,11488,10675,813,7.1
53033,2016,1213744,1167122,46622,3.8
53035,2016,117955,111377,6578,5.6
53037,2016,21495,20212,1283,6
53039,2016,9627,8970,657,6.8
53041,2016,31866,29375,2491,7.8
53043,2016,4882,4609,273,5.6
53045,2016,23464,21690,1774,7.6
53047,2016,21373,19946,1427,6.7
53049,2016,8277,7609,668,8.1
53051,2016,4654,4238,416,8.9
53053,2016,403890,379561,24329,6
53055,2016,7860,7491,369,4.7
53057,2016,57868,54089,3779,6.5
53059,2016,5065,4713,352,6.9
53061,2016,415507,397933,17574,4.2
53063,2016,234083,219816,14267,6.1
53065,2016,17859,16385,1474,8.300000000000001
53067,2016,129543,122228,7315,5.6
53069,2016,1286,1175,111,8.6
53071,2016,28661,27107,1554,5.4
53073,2016,106929,100688,6241,5.8
53075,2016,23064,21907,1157,5
53077,2016,125655,116117,9538,7.6
54001,2016,6958,6484,474,6.8
54003,2016,54066,51923,2143,4
54005,2016,7986,7258,728,9.1
54007,2016,5490,5008,482,8.800000000000001
54009,2016,9976,9272,704,7.1
54011,2016,41199,39214,1985,4.8
54013,2016,2621,2284,337,12.9
54015,2016,3258,2920,338,10.4
54017,2016,3780,3584,196,5.2
54019,2016,15967,14699,1268,7.9
54021,2016,2539,2329,210,8.300000000000001
54023,2016,5953,5599,354,5.9
54025,2016,15680,14832,848,5.4
54027,2016,9892,9461,431,4.4
54029,2016,12854,11952,902,7
54031,2016,5715,5389,326,5.7
54033,2016,32336,30446,1890,5.8
54035,2016,12001,11222,779,6.5
54037,2016,28546,27584,962,3.4
54039,2016,85268,80606,4662,5.5
54041,2016,6826,6245,581,8.5
54043,2016,7287,6664,623,8.5
54045,2016,11154,10015,1139,10.2
54047,2016,5083,4464,619,12.2
54049,2016,25662,23982,1680,6.5
54051,2016,14061,12939,1122,8
54053,2016,10027,9311,716,7.1
54055,2016,21680,20228,1452,6.7
54057,2016,11905,11195,710,6
54059,2016,6726,5877,849,12.6
54061,2016,51263,49043,2220,4.3
54063,2016,5976,5704,272,4.6
54065,2016,7652,7316,336,4.4
54067,2016,9584,8738,846,8.800000000000001
54069,2016,20621,19476,1145,5.6
54071,2016,3653,3511,142,3.9
54073,2016,2953,2711,242,8.199999999999999
54075,2016,3725,3477,248,6.7
54077,2016,14847,13993,854,5.8
54079,2016,25765,24505,1260,4.9
54081,2016,29925,27831,2094,7
54083,2016,12201,11470,731,6
54085,2016,4562,4263,299,6.6
54087,2016,5200,4664,536,10.3
54089,2016,4568,4288,280,6.1
54091,2016,7816,7375,441,5.6
54093,2016,3475,3287,188,5.4
54095,2016,3546,3230,316,8.9
54097,2016,9802,9062,740,7.5
54099,2016,15526,14500,1026,6.6
54101,2016,3489,3198,291,8.300000000000001
54103,2016,7199,6533,666,9.300000000000001
54105,2016,2230,2034,196,8.800000000000001
54107,2016,36806,34691,2115,5.7
54109,2016,7417,6660,757,10.2
55001,2016,8296,7796,500,6
55003,2016,7967,7535,432,5.4
55005,2016,24389,23280,1109,4.5
55007,2016,7547,7027,520,6.9
55009,2016,141375,136269,5106,3.6
55011,2016,6583,6289,294,4.5
55013,2016,7188,6757,431,6
55015,2016,27761,26871,890,3.2
55017,2016,33414,31993,1421,4.3
55019,2016,17558,16873,685,3.9
55021,2016,31623,30485,1138,3.6
55023,2016,7934,7547,387,4.9
55025,2016,318231,309163,9068,2.8
55027,2016,47942,46196,1746,3.6
55029,2016,15530,14761,769,5
55031,2016,23606,22369,1237,5.2
55033,2016,24363,23368,995,4.1
55035,2016,58968,56957,2011,3.4
55037,2016,2232,2100,132,5.9
55039,2016,57020,55016,2004,3.5
55041,2016,4006,3757,249,6.2
55043,2016,28247,27144,1103,3.9
55045,2016,21240,20534,706,3.3
55047,2016,9778,9301,477,4.9
55049,2016,13720,13239,481,3.5
55051,2016,2642,2446,196,7.4
55053,2016,10344,9891,453,4.4
55055,2016,45775,43996,1779,3.9
55057,2016,13559,12959,600,4.4
55059,2016,88448,84339,4109,4.6
55061,2016,11051,10646,405,3.7
55063,2016,67666,65227,2439,3.6
55065,2016,9859,9546,313,3.2
55067,2016,9591,9094,497,5.2
55069,2016,15285,14618,667,4.4
55071,2016,41912,40109,1803,4.3
55073,2016,73739,71117,2622,3.6
55075,2016,20266,19157,1109,5.5
55077,2016,7566,7182,384,5.1
55078,2016,1577,1457,120,7.6
55079,2016,477381,453685,23696,5
55081,2016,23063,22183,880,3.8
55083,2016,20496,19591,905,4.4
55085,2016,18617,17713,904,4.9
55087,2016,104042,100371,3671,3.5
55089,2016,49120,47484,1636,3.3
55091,2016,4174,4015,159,3.8
55093,2016,24722,23723,999,4
55095,2016,24921,23780,1141,4.6
55097,2016,39555,38046,1509,3.8
55099,2016,6894,6598,296,4.3
55101,2016,99890,94975,4915,4.9
55103,2016,9280,8931,349,3.8
55105,2016,84246,80545,3701,4.4
55107,2016,7015,6656,359,5.1
55109,2016,49746,47872,1874,3.8
55111,2016,35291,34033,1258,3.6
55113,2016,7933,7438,495,6.2
55115,2016,21328,20443,885,4.1
55117,2016,61829,59732,2097,3.4
55119,2016,11098,10640,458,4.1
55121,2016,16693,16077,616,3.7
55123,2016,15785,15209,576,3.6
55125,2016,9992,9426,566,5.7
55127,2016,57796,55490,2306,4
55129,2016,7989,7591,398,5
55131,2016,77322,74739,2583,3.3
55133,2016,225184,217425,7759,3.4
55135,2016,27016,25950,1066,3.9
55137,2016,11500,10922,578,5
55139,2016,93217,89901,3316,3.6
55141,2016,34671,33038,1633,4.7
56001,2016,20960,20287,673,3.2
56003,2016,5536,5260,276,5
56005,2016,24396,22635,1761,7.2
56007,2016,8358,7965,393,4.7
56009,2016,7873,7381,492,6.2
56011,2016,3737,3565,172,4.6
56013,2016,20026,18581,1445,7.2
56015,2016,7024,6780,244,3.5
56017,2016,2424,2307,117,4.8
56019,2016,4205,3979,226,5.4
56021,2016,48772,46740,2032,4.2
56023,2016,8719,8308,411,4.7
56025,2016,40985,38052,2933,7.2
56027,2016,1338,1294,44,3.3
56029,2016,15922,15167,755,4.7
56031,2016,4772,4542,230,4.8
56033,2016,16118,15355,763,4.7
56035,2016,4229,3956,273,6.5
56037,2016,22125,20782,1343,6.1
56039,2016,15237,14708,529,3.5
56041,2016,9420,8871,549,5.8
56043,2016,4212,4011,201,4.8
56045,2016,3957,3759,198,5
72001,2016,4470,3717,753,16.8
72003,2016,11907,10245,1662,14
72005,2016,14906,12689,2217,14.9
72007,2016,6787,5814,973,14.3
72009,2016,6673,5680,993,14.9
72011,2016,8893,7749,1144,12.9
72013,2016,23997,20832,3165,13.2
72015,2016,5140,4187,953,18.5
72017,2016,5863,5034,829,14.1
72019,2016,7480,6521,959,12.8
72021,2016,66356,60399,5957,9
72023,2016,14168,12405,1763,12.4
72025,2016,48264,43281,4983,10.3
72027,2016,9505,8330,1175,12.4
72029,2016,16274,14404,1870,11.5
72031,2016,62164,56791,5373,8.6
72033,2016,7912,7119,793,10
72035,2016,16220,14480,1740,10.7
72037,2016,3798,3301,497,13.1
72039,2016,3839,3220,619,16.1
72041,2016,15580,13986,1594,10.2
72043,2016,10868,8903,1965,18.1
72045,2016,5072,4389,683,13.5
72047,2016,9250,8114,1136,12.3
72049,2016,896,866,30,3.3
72051,2016,12924,11882,1042,8.1
72053,2016,11285,9728,1557,13.8
72054,2016,3370,2882,488,14.5
72055,2016,4142,3394,748,18.1
72057,2016,12052,10076,1976,16.4
72059,2016,5292,4302,990,18.7
72061,2016,37190,34975,2215,6
72063,2016,17513,16026,1487,8.5
72065,2016,13323,11253,2070,15.5
72067,2016,5621,4933,688,12.2
72069,2016,17467,15004,2463,14.1
72071,2016,12613,10835,1778,14.1
72073,2016,4221,3675,546,12.9
72075,2016,15597,13338,2259,14.5
72077,2016,12462,10817,1645,13.2
72079,2016,5631,4580,1051,18.7
72081,2016,7412,5980,1432,19.3
72083,2016,2865,2439,426,14.9
72085,2016,11365,9835,1530,13.5
72087,2016,8654,7675,979,11.3
72089,2016,6333,5434,899,14.2
72091,2016,11648,10295,1353,11.6
72093,2016,1955,1657,298,15.2
72095,2016,3020,2466,554,18.3
72097,2016,23225,20039,3186,13.7
72099,2016,10745,9073,1672,15.6
72101,2016,8119,7027,1092,13.4
72103,2016,8086,7089,997,12.3
72105,2016,7260,6319,941,13
72107,2016,5204,4397,807,15.5
72109,2016,4813,3820,993,20.6
72111,2016,6120,5099,1021,16.7
72113,2016,47812,41397,6415,13.4
72115,2016,6079,5109,970,16
72117,2016,4631,3908,723,15.6
72119,2016,17095,15303,1792,10.5
72121,2016,6446,5424,1022,15.9
72123,2016,7568,5928,1640,21.7
72125,2016,10356,8775,1581,15.3
72127,2016,135159,124495,10664,7.9
72129,2016,11910,10418,1492,12.5
72131,2016,10721,8694,2027,18.9
72133,2016,9898,8244,1654,16.7
72135,2016,26551,24343,2208,8.300000000000001
72137,2016,29753,27071,2682,9
72139,2016,27127,25174,1953,7.2
72141,2016,6885,5817,1068,15.5
72143,2016,9878,8740,1138,11.5
72145,2016,13733,11829,1904,13.9
72147,2016,3260,2914,346,10.6
72149,2016,7815,6235,1580,20.2
72151,2016,9081,7545,1536,16.9
72153,2016,10735,8719,2016,18.8
,,,,,
,,,,,
,,,,,
1001,2017,26075,25062,1013,3.9
1003,2017,92456,88711,3745,4.1
1005,2017,8349,7863,486,5.8
1007,2017,8583,8208,375,4.4
1009,2017,24822,23824,998,4
1011,2017,4852,4614,238,4.9
1013,2017,8975,8481,494,5.5
1015,2017,45950,43679,2271,4.9
1017,2017,15260,14639,621,4.1
1019,2017,11385,10922,463,4.1
1021,2017,19333,18547,786,4.1
1023,2017,4424,4145,279,6.3
1025,2017,7765,7107,658,8.5
1027,2017,5819,5567,252,4.3
1029,2017,5747,5489,258,4.5
1031,2017,20969,20049,920,4.4
1033,2017,23343,22130,1213,5.2
1035,2017,4505,4230,275,6.1
1037,2017,4396,4191,205,4.7
1039,2017,15779,14958,821,5.2
1041,2017,6429,6138,291,4.5
1043,2017,37976,36556,1420,3.7
1045,2017,20014,19120,894,4.5
1047,2017,15084,13956,1128,7.5
1049,2017,29688,28357,1331,4.5
1051,2017,37366,35990,1376,3.7
1053,2017,14501,13779,722,5
1055,2017,43233,41251,1982,4.6
1057,2017,6579,6269,310,4.7
1059,2017,14029,13430,599,4.3
1061,2017,10826,10356,470,4.3
1063,2017,2861,2645,216,7.5
1065,2017,5968,5614,354,5.9
1067,2017,6739,6411,328,4.9
1069,2017,44882,42923,1959,4.4
1071,2017,23198,22088,1110,4.8
1073,2017,311481,298227,13254,4.3
1075,2017,5764,5523,241,4.2
1077,2017,42218,40261,1957,4.6
1079,2017,13690,13015,675,4.9
1081,2017,73762,70836,2926,4
1083,2017,41691,40016,1675,4
1085,2017,3672,3371,301,8.199999999999999
1087,2017,7916,7460,456,5.8
1089,2017,176562,169711,6851,3.9
1091,2017,7724,7291,433,5.6
1093,2017,12567,11964,603,4.8
1095,2017,42240,40616,1624,3.8
1097,2017,187560,177819,9741,5.2
1099,2017,7243,6756,487,6.7
1101,2017,106155,101555,4600,4.3
1103,2017,55252,52986,2266,4.1
1105,2017,3449,3181,268,7.8
1107,2017,7748,7333,415,5.4
1109,2017,15351,14606,745,4.9
1111,2017,9521,9104,417,4.4
1113,2017,23481,22468,1013,4.3
1115,2017,39341,37780,1561,4
1117,2017,111770,108172,3598,3.2
1119,2017,4986,4659,327,6.6
1121,2017,34780,33040,1740,5
1123,2017,18273,17505,768,4.2
1125,2017,100259,96091,4168,4.2
1127,2017,24996,23738,1258,5
1129,2017,6717,6263,454,6.8
1131,2017,2812,2491,321,11.4
1133,2017,9730,9241,489,5
2013,2017,2529,2466,63,2.5
2016,2017,3724,3587,137,3.7
2020,2017,153108,144255,8853,5.8
2050,2017,7326,6343,983,13.4
2060,2017,419,393,26,6.2
2068,2017,1144,1042,102,8.9
2070,2017,2045,1863,182,8.9
2090,2017,46234,43429,2805,6.1
2100,2017,1077,982,95,8.800000000000001
2105,2017,1136,998,138,12.1
2110,2017,17208,16417,791,4.6
2122,2017,26749,24551,2198,8.199999999999999
2130,2017,7066,6634,432,6.1
2150,2017,6292,5977,315,5
2158,2017,2746,2209,537,19.6
2164,2017,716,632,84,11.7
2170,2017,48126,44174,3952,8.199999999999999
2180,2017,4089,3597,492,12
2185,2017,3585,3321,264,7.4
2188,2017,2951,2476,475,16.1
2195,2017,1411,1283,128,9.1
2198,2017,2840,2527,313,11
2220,2017,4426,4227,199,4.5
2230,2017,826,742,84,10.2
2240,2017,2927,2629,298,10.2
2261,2017,4856,4484,372,7.7
2275,2017,1045,966,79,7.6
2282,2017,232,211,21,9.1
2290,2017,2466,2034,432,17.5
4001,2017,20361,18274,2087,10.2
4003,2017,49327,46592,2735,5.5
4005,2017,75401,71251,4150,5.5
4007,2017,21306,20025,1281,6
4009,2017,14358,13581,777,5.4
4011,2017,3983,3784,199,5
4012,2017,8681,8216,465,5.4
4013,2017,2141365,2052091,89274,4.2
4015,2017,82349,77541,4808,5.8
4017,2017,40684,37591,3093,7.6
4019,2017,475935,454630,21305,4.5
4021,2017,171474,162883,8591,5
4023,2017,19051,17255,1796,9.4
4025,2017,101851,97269,4582,4.5
4027,2017,95437,79266,16171,16.9
5001,2017,8960,8669,291,3.2
5003,2017,7857,7420,437,5.6
5005,2017,16350,15655,695,4.3
5007,2017,132347,128439,3908,3
5009,2017,15782,15242,540,3.4
5011,2017,4454,4250,204,4.6
5013,2017,2408,2315,93,3.9
5015,2017,12979,12548,431,3.3
5017,2017,3462,3237,225,6.5
5019,2017,9566,9194,372,3.9
5021,2017,5876,5611,265,4.5
5023,2017,9276,8821,455,4.9
5025,2017,3324,3180,144,4.3
5027,2017,9069,8612,457,5
5029,2017,8222,7830,392,4.8
5031,2017,53541,51936,1605,3
5033,2017,26904,25958,946,3.5
5035,2017,21357,20427,930,4.4
5037,2017,7648,7342,306,4
5039,2017,2916,2788,128,4.4
5041,2017,5442,5181,261,4.8
5043,2017,7953,7550,403,5.1
5045,2017,61295,59256,2039,3.3
5047,2017,7395,7135,260,3.5
5049,2017,4713,4515,198,4.2
5051,2017,40296,38671,1625,4
5053,2017,8317,8049,268,3.2
5055,2017,19701,18977,724,3.7
5057,2017,9886,9546,340,3.4
5059,2017,14106,13585,521,3.7
5061,2017,5982,5802,180,3
5063,2017,16126,15443,683,4.2
5065,2017,4875,4606,269,5.5
5067,2017,5874,5530,344,5.9
5069,2017,27970,26522,1448,5.2
5071,2017,10566,10115,451,4.3
5073,2017,2537,2409,128,5
5075,2017,6850,6593,257,3.8
5077,2017,2965,2823,142,4.8
5079,2017,4048,3880,168,4.2
5081,2017,5493,5228,265,4.8
5083,2017,8888,8548,340,3.8
5085,2017,33815,32711,1104,3.3
5087,2017,7363,7153,210,2.9
5089,2017,6473,6218,255,3.9
5091,2017,19740,18884,856,4.3
5093,2017,17764,16710,1054,5.9
5095,2017,2796,2677,119,4.3
5097,2017,3088,2941,147,4.8
5099,2017,3600,3473,127,3.5
5101,2017,3319,3199,120,3.6
5103,2017,9714,9270,444,4.6
5105,2017,4241,4066,175,4.1
5107,2017,6525,6148,377,5.8
5109,2017,4290,4118,172,4
5111,2017,10247,9822,425,4.1
5113,2017,8020,7661,359,4.5
5115,2017,29065,27775,1290,4.4
5117,2017,3693,3542,151,4.1
5119,2017,188293,181884,6409,3.4
5121,2017,6916,6629,287,4.1
5123,2017,8353,7933,420,5
5125,2017,57432,55701,1731,3
5127,2017,4430,4277,153,3.5
5129,2017,2933,2797,136,4.6
5131,2017,57164,55104,2060,3.6
5133,2017,5659,5404,255,4.5
5135,2017,5954,5656,298,5
5137,2017,4788,4560,228,4.8
5139,2017,16079,15232,847,5.3
5141,2017,6034,5705,329,5.5
5143,2017,120584,117465,3119,2.6
5145,2017,33599,32074,1525,4.5
5147,2017,2922,2781,141,4.8
5149,2017,8551,8207,344,4
6001,2017,839215,808382,30833,3.7
6003,2017,548,515,33,6
6005,2017,14710,13980,730,5
6007,2017,102114,96209,5905,5.8
6009,2017,21040,20046,994,4.7
6011,2017,10820,9282,1538,14.2
6013,2017,558591,537156,21435,3.8
6015,2017,9707,9083,624,6.4
6017,2017,89824,85902,3922,4.4
6019,2017,444862,406912,37950,8.5
6021,2017,12816,11859,957,7.5
6023,2017,62559,59937,2622,4.2
6025,2017,72060,57977,14083,19.5
6027,2017,8615,8239,376,4.4
6029,2017,384402,349050,35352,9.199999999999999
6031,2017,57315,52216,5099,8.9
6033,2017,29336,27642,1694,5.8
6035,2017,10037,9484,553,5.5
6037,2017,5084014,4841864,242150,4.8
6039,2017,60966,56021,4945,8.1
6041,2017,139822,135799,4023,2.9
6043,2017,7662,7215,447,5.8
6045,2017,39584,37796,1788,4.5
6047,2017,115306,104497,10809,9.4
6049,2017,3196,2937,259,8.1
6051,2017,8496,8119,377,4.4
6053,2017,219706,203958,15748,7.2
6055,2017,73332,70661,2671,3.6
6057,2017,48349,46362,1987,4.1
6059,2017,1607793,1551463,56330,3.5
6061,2017,181460,174454,7006,3.9
6063,2017,7770,7081,689,8.9
6065,2017,1072154,1015843,56311,5.3
6067,2017,697323,664782,32541,4.7
6069,2017,30622,28857,1765,5.8
6071,2017,943144,896687,46457,4.9
6073,2017,1572801,1509574,63227,4
6075,2017,563815,547308,16507,2.9
6077,2017,323289,300683,22606,7
6079,2017,140434,135385,5049,3.6
6081,2017,445523,433416,12107,2.7
6083,2017,215214,205471,9743,4.5
6085,2017,1038698,1005277,33421,3.2
6087,2017,142762,134637,8125,5.7
6089,2017,73996,69705,4291,5.8
6091,2017,1290,1206,84,6.5
6093,2017,17803,16511,1292,7.3
6095,2017,208199,198274,9925,4.8
6097,2017,260114,251331,8783,3.4
6099,2017,242212,224091,18121,7.5
6101,2017,45005,41094,3911,8.699999999999999
6103,2017,25539,23914,1625,6.4
6105,2017,4809,4511,298,6.2
6107,2017,204616,183249,21367,10.4
6109,2017,21393,20240,1153,5.4
6111,2017,424156,405104,19052,4.5
6113,2017,106684,101244,5440,5.1
6115,2017,28747,26612,2135,7.4
8001,2017,260525,252646,7879,3
8003,2017,8132,7855,277,3.4
8005,2017,350170,340529,9641,2.8
8007,2017,6611,6412,199,3
8009,2017,2119,2085,34,1.6
8011,2017,1923,1870,53,2.8
8013,2017,186420,181964,4456,2.4
8014,2017,38501,37505,996,2.6
8015,2017,9295,9079,216,2.3
8017,2017,1132,1112,20,1.8
8019,2017,5863,5712,151,2.6
8021,2017,3921,3759,162,4.1
8023,2017,1821,1757,64,3.5
8025,2017,1469,1424,45,3.1
8027,2017,2031,1970,61,3
8029,2017,14271,13721,550,3.9
8031,2017,398590,387741,10849,2.7
8033,2017,1128,1095,33,2.9
8035,2017,184585,180221,4364,2.4
8037,2017,34772,33970,802,2.3
8039,2017,14379,14033,346,2.4
8041,2017,325388,314855,10533,3.2
8043,2017,14949,14314,635,4.2
8045,2017,31499,30597,902,2.9
8047,2017,3597,3525,72,2
8049,2017,9532,9319,213,2.2
8051,2017,10678,10463,215,2
8053,2017,473,462,11,2.3
8055,2017,2550,2404,146,5.7
8057,2017,959,942,17,1.8
8059,2017,322789,314385,8404,2.6
8061,2017,922,906,16,1.7
8063,2017,4375,4301,74,1.7
8065,2017,4707,4607,100,2.1
8067,2017,31386,30626,760,2.4
8069,2017,194947,190257,4690,2.4
8071,2017,6253,6004,249,4
8073,2017,2376,2327,49,2.1
8075,2017,11091,10833,258,2.3
8077,2017,73596,70704,2892,3.9
8079,2017,464,455,9,1.9
8081,2017,7319,7077,242,3.3
8083,2017,12836,12332,504,3.9
8085,2017,20790,20110,680,3.3
8087,2017,15560,15186,374,2.4
8089,2017,8263,7924,339,4.1
8091,2017,2259,2195,64,2.8
8093,2017,10451,10206,245,2.3
8095,2017,2570,2529,41,1.6
8097,2017,10974,10639,335,3.1
8099,2017,6188,6028,160,2.6
8101,2017,74672,71495,3177,4.3
8103,2017,2782,2674,108,3.9
8105,2017,5365,5135,230,4.3
8107,2017,15534,15167,367,2.4
8109,2017,3433,3283,150,4.4
8111,2017,527,515,12,2.3
8113,2017,5338,5187,151,2.8
8115,2017,1189,1164,25,2.1
8117,2017,21813,21409,404,1.9
8119,2017,12230,11842,388,3.2
8121,2017,3024,2966,58,1.9
8123,2017,157550,153366,4184,2.7
8125,2017,5668,5578,90,1.6
9001,2017,479458,457625,21833,4.6
9003,2017,477390,454205,23185,4.9
9005,2017,104051,99522,4529,4.4
9007,2017,92583,88817,3766,4.1
9009,2017,457800,434645,23155,5.1
9011,2017,137470,131267,6203,4.5
9013,2017,85802,82362,3440,4
9015,2017,63088,59886,3202,5.1
10001,2017,77446,73667,3779,4.9
10003,2017,295508,282545,12963,4.4
10005,2017,103317,98716,4601,4.5
11001,2017,401021,376716,24305,6.1
12001,2017,135590,130393,5197,3.8
12003,2017,11668,11178,490,4.2
12005,2017,88359,84675,3684,4.2
12007,2017,11268,10855,413,3.7
12009,2017,269221,257525,11696,4.3
12011,2017,1023413,982614,40799,4
12013,2017,4980,4736,244,4.9
12015,2017,70121,66783,3338,4.8
12017,2017,47927,45097,2830,5.9
12019,2017,104297,100222,4075,3.9
12021,2017,173522,166305,7217,4.2
12023,2017,29364,28076,1288,4.4
12027,2017,14067,13435,632,4.5
12029,2017,5756,5481,275,4.8
12031,2017,478819,458384,20435,4.3
12033,2017,142287,136297,5990,4.2
12035,2017,46217,43985,2232,4.8
12037,2017,4706,4535,171,3.6
12039,2017,18186,17184,1002,5.5
12041,2017,6830,6526,304,4.5
12043,2017,4958,4691,267,5.4
12045,2017,6021,5785,236,3.9
12047,2017,4319,4109,210,4.9
12049,2017,8977,8448,529,5.9
12051,2017,16027,14854,1173,7.3
12053,2017,69483,65820,3663,5.3
12055,2017,36449,34377,2072,5.7
12057,2017,725510,696922,28588,3.9
12059,2017,6901,6571,330,4.8
12061,2017,64032,60796,3236,5.1
12063,2017,17327,16542,785,4.5
12065,2017,5505,5264,241,4.4
12067,2017,2946,2835,111,3.8
12069,2017,151233,144851,6382,4.2
12071,2017,335681,321870,13811,4.1
12073,2017,152359,146378,5981,3.9
12075,2017,16800,16047,753,4.5
12077,2017,2624,2504,120,4.6
12079,2017,7380,7050,330,4.5
12081,2017,175030,168020,7010,4
12083,2017,133929,127142,6787,5.1
12085,2017,72163,69125,3038,4.2
12086,2017,1359864,1298510,61354,4.5
12087,2017,45731,44232,1499,3.3
12089,2017,39196,37662,1534,3.9
12091,2017,94533,91236,3297,3.5
12093,2017,18367,17559,808,4.4
12095,2017,730111,702466,27645,3.8
12097,2017,173284,165753,7531,4.3
12099,2017,723093,692769,30324,4.2
12101,2017,228589,218330,10259,4.5
12103,2017,484810,466184,18626,3.8
12105,2017,293786,279636,14150,4.8
12107,2017,27068,25587,1481,5.5
12109,2017,125066,120801,4265,3.4
12111,2017,139386,132155,7231,5.2
12113,2017,79147,76050,3097,3.9
12115,2017,184887,177553,7334,4
12117,2017,247566,238299,9267,3.7
12119,2017,30299,28437,1862,6.1
12121,2017,18367,17580,787,4.3
12123,2017,8781,8385,396,4.5
12125,2017,4820,4638,182,3.8
12127,2017,250050,238896,11154,4.5
12129,2017,14507,13983,524,3.6
12131,2017,30079,28972,1107,3.7
12133,2017,9798,9367,431,4.4
13001,2017,9245,8741,504,5.5
13003,2017,4158,3973,185,4.4
13005,2017,5044,4821,223,4.4
13007,2017,1234,1158,76,6.2
13009,2017,17561,16538,1023,5.8
13011,2017,9256,8898,358,3.9
13013,2017,39123,37548,1575,4
13015,2017,49463,47201,2262,4.6
13017,2017,5457,5036,421,7.7
13019,2017,7375,7000,375,5.1
13021,2017,69412,65754,3658,5.3
13023,2017,4572,4267,305,6.7
13025,2017,7289,6876,413,5.7
13027,2017,7030,6715,315,4.5
13029,2017,17573,16841,732,4.2
13031,2017,36595,34764,1831,5
13033,2017,9316,8657,659,7.1
13035,2017,10597,10092,505,4.8
13037,2017,2243,2126,117,5.2
13039,2017,20810,19762,1048,5
13043,2017,5218,5006,212,4.1
13045,2017,54782,52048,2734,5
13047,2017,32789,31445,1344,4.1
13049,2017,4850,4608,242,5
13051,2017,138565,132390,6175,4.5
13053,2017,1984,1850,134,6.8
13055,2017,10535,10042,493,4.7
13057,2017,130797,125939,4858,3.7
13059,2017,60792,57928,2864,4.7
13061,2017,866,788,78,9
13063,2017,134864,127048,7816,5.8
13065,2017,2769,2618,151,5.5
13067,2017,420122,403070,17052,4.1
13069,2017,18415,17484,931,5.1
13071,2017,22032,21046,986,4.5
13073,2017,74104,71074,3030,4.1
13075,2017,7699,7353,346,4.5
13077,2017,72498,69481,3017,4.2
13079,2017,5720,5440,280,4.9
13081,2017,9382,8898,484,5.2
13083,2017,8190,7835,355,4.3
13085,2017,11855,11399,456,3.8
13087,2017,11635,10994,641,5.5
13089,2017,394399,375592,18807,4.8
13091,2017,7117,6675,442,6.2
13093,2017,5076,4821,255,5
13095,2017,38827,36503,2324,6
13097,2017,71904,68410,3494,4.9
13099,2017,4523,4279,244,5.4
13101,2017,1901,1827,74,3.9
13103,2017,29406,28225,1181,4
13105,2017,7844,7435,409,5.2
13107,2017,8576,8006,570,6.6
13109,2017,4881,4669,212,4.3
13111,2017,10960,10439,521,4.8
13113,2017,56870,54570,2300,4
13115,2017,44121,41842,2279,5.2
13117,2017,116234,111910,4324,3.7
13119,2017,10058,9582,476,4.7
13121,2017,547741,521497,26244,4.8
13123,2017,11984,11384,600,5
13125,2017,1297,1233,64,4.9
13127,2017,39732,37868,1864,4.7
13129,2017,26616,25396,1220,4.6
13131,2017,10726,10207,519,4.8
13133,2017,6816,6467,349,5.1
13135,2017,481154,460937,20217,4.2
13137,2017,19265,18393,872,4.5
13139,2017,100178,96297,3881,3.9
13141,2017,2524,2346,178,7.1
13143,2017,12360,11772,588,4.8
13145,2017,16614,15928,686,4.1
13147,2017,11228,10733,495,4.4
13149,2017,5157,4902,255,4.9
13151,2017,112194,106788,5406,4.8
13153,2017,69043,65803,3240,4.7
13155,2017,3274,3047,227,6.9
13157,2017,35227,33943,1284,3.6
13159,2017,6842,6549,293,4.3
13161,2017,6117,5750,367,6
13163,2017,6732,6319,413,6.1
13165,2017,3159,2947,212,6.7
13167,2017,4092,3886,206,5
13169,2017,13909,13311,598,4.3
13171,2017,8031,7585,446,5.6
13173,2017,3838,3644,194,5.1
13175,2017,19240,18116,1124,5.8
13177,2017,15016,14397,619,4.1
13179,2017,25450,24148,1302,5.1
13181,2017,3562,3377,185,5.2
13183,2017,7959,7577,382,4.8
13185,2017,51590,49208,2382,4.6
13187,2017,16701,16015,686,4.1
13189,2017,8877,8326,551,6.2
13191,2017,6125,5817,308,5
13193,2017,4708,4383,325,6.9
13195,2017,13535,12960,575,4.2
13197,2017,3418,3214,204,6
13199,2017,8845,8326,519,5.9
13201,2017,2815,2691,124,4.4
13205,2017,8478,7952,526,6.2
13207,2017,13081,12501,580,4.4
13209,2017,3756,3510,246,6.5
13211,2017,8971,8571,400,4.5
13213,2017,15827,14858,969,6.1
13215,2017,78847,74199,4648,5.9
13217,2017,51125,48427,2698,5.3
13219,2017,19432,18750,682,3.5
13221,2017,7041,6739,302,4.3
13223,2017,82651,79259,3392,4.1
13225,2017,11736,11053,683,5.8
13227,2017,14948,14314,634,4.2
13229,2017,8774,8379,395,4.5
13231,2017,8644,8261,383,4.4
13233,2017,18445,17487,958,5.2
13235,2017,4084,3871,213,5.2
13237,2017,8156,7688,468,5.7
13239,2017,832,783,49,5.9
13241,2017,6892,6555,337,4.9
13243,2017,2510,2348,162,6.5
13245,2017,85796,80713,5083,5.9
13247,2017,44319,41991,2328,5.3
13249,2017,2207,2087,120,5.4
13251,2017,5258,4931,327,6.2
13253,2017,3079,2883,196,6.4
13255,2017,28269,26635,1634,5.8
13257,2017,11008,10438,570,5.2
13259,2017,2277,2142,135,5.9
13261,2017,12874,12006,868,6.7
13263,2017,2789,2619,170,6.1
13265,2017,574,536,38,6.6
13267,2017,9575,9105,470,4.9
13269,2017,2813,2570,243,8.6
13271,2017,4774,4403,371,7.8
13273,2017,3659,3441,218,6
13275,2017,17178,16188,990,5.8
13277,2017,19092,18208,884,4.6
13279,2017,11792,11027,765,6.5
13281,2017,3756,3511,245,6.5
13283,2017,2728,2546,182,6.7
13285,2017,37293,35663,1630,4.4
13287,2017,3268,3086,182,5.6
13289,2017,2962,2740,222,7.5
13291,2017,10134,9680,454,4.5
13293,2017,11253,10642,611,5.4
13295,2017,30808,29427,1381,4.5
13297,2017,44646,42728,1918,4.3
13299,2017,15794,15083,711,4.5
13301,2017,2718,2560,158,5.8
13303,2017,7352,6922,430,5.8
13305,2017,11333,10691,642,5.7
13307,2017,991,917,74,7.5
13309,2017,1735,1581,154,8.9
13311,2017,15672,15072,600,3.8
13313,2017,44842,42417,2425,5.4
13315,2017,2760,2601,159,5.8
13317,2017,3807,3594,213,5.6
13319,2017,3802,3589,213,5.6
13321,2017,9249,8803,446,4.8
15001,2017,93566,90923,2643,2.8
15003,2017,464734,453882,10852,2.3
15007,2017,37202,36317,885,2.4
15009,2017,88298,86033,2265,2.6
16001,2017,234405,227785,6620,2.8
16003,2017,1748,1647,101,5.8
16005,2017,41490,40216,1274,3.1
16007,2017,2830,2739,91,3.2
16009,2017,4007,3781,226,5.6
16011,2017,23025,22337,688,3
16013,2017,12224,11908,316,2.6
16015,2017,3204,3050,154,4.8
16017,2017,19255,18380,875,4.5
16019,2017,53538,52089,1449,2.7
16021,2017,5150,4903,247,4.8
16023,2017,1332,1292,40,3
16025,2017,682,663,19,2.8
16027,2017,96538,93030,3508,3.6
16029,2017,3863,3741,122,3.2
16031,2017,11718,11424,294,2.5
16033,2017,398,387,11,2.8
16035,2017,3006,2795,211,7
16037,2017,2158,2066,92,4.3
16039,2017,11185,10774,411,3.7
16041,2017,6751,6595,156,2.3
16043,2017,7613,7410,203,2.7
16045,2017,7867,7552,315,4
16047,2017,8021,7822,199,2.5
16049,2017,6310,5996,314,5
16051,2017,13075,12742,333,2.5
16053,2017,11637,11308,329,2.8
16055,2017,75707,72754,2953,3.9
16057,2017,20044,19509,535,2.7
16059,2017,3477,3295,182,5.2
16061,2017,1614,1519,95,5.9
16063,2017,2702,2614,88,3.3
16065,2017,21172,20771,401,1.9
16067,2017,10988,10693,295,2.7
16069,2017,21158,20552,606,2.9
16071,2017,2255,2190,65,2.9
16073,2017,5304,5093,211,4
16075,2017,11484,11026,458,4
16077,2017,3955,3819,136,3.4
16079,2017,5036,4716,320,6.4
16081,2017,6130,5973,157,2.6
16083,2017,40114,38898,1216,3
16085,2017,5141,4912,229,4.5
16087,2017,4602,4385,217,4.7
17001,2017,32393,31129,1264,3.9
17003,2017,2131,1954,177,8.300000000000001
17005,2017,7921,7570,351,4.4
17007,2017,26172,24412,1760,6.7
17009,2017,2861,2779,82,2.9
17011,2017,17399,16544,855,4.9
17013,2017,2338,2210,128,5.5
17015,2017,7622,7268,354,4.6
17017,2017,6155,5875,280,4.5
17019,2017,106845,102259,4586,4.3
17021,2017,14782,13995,787,5.3
17023,2017,7880,7494,386,4.9
17025,2017,6649,6293,356,5.4
17027,2017,20307,19583,724,3.6
17029,2017,24556,23404,1152,4.7
17031,2017,2632107,2497953,134154,5.1
17033,2017,8834,8369,465,5.3
17035,2017,6127,5882,245,4
17037,2017,54841,52292,2549,4.6
17039,2017,7697,7333,364,4.7
17041,2017,10244,9823,421,4.1
17043,2017,511412,491133,20279,4
17045,2017,9459,8996,463,4.9
17047,2017,2850,2718,132,4.6
17049,2017,18893,18175,718,3.8
17051,2017,9684,9147,537,5.5
17053,2017,6449,6137,312,4.8
17055,2017,16544,15468,1076,6.5
17057,2017,15485,14492,993,6.4
17059,2017,2467,2324,143,5.8
17061,2017,6021,5713,308,5.1
17063,2017,25489,24017,1472,5.8
17065,2017,4464,4262,202,4.5
17067,2017,8522,8082,440,5.2
17069,2017,1353,1248,105,7.8
17071,2017,3650,3462,188,5.2
17073,2017,25002,23718,1284,5.1
17075,2017,14598,13931,667,4.6
17077,2017,28071,26806,1265,4.5
17079,2017,4489,4263,226,5
17081,2017,17495,16534,961,5.5
17083,2017,10953,10422,531,4.8
17085,2017,11062,10566,496,4.5
17087,2017,4118,3808,310,7.5
17089,2017,269581,256477,13104,4.9
17091,2017,54826,51810,3016,5.5
17093,2017,68053,65093,2960,4.3
17095,2017,22500,21327,1173,5.2
17097,2017,372571,355660,16911,4.5
17099,2017,56199,53039,3160,5.6
17101,2017,6067,5698,369,6.1
17103,2017,17822,17042,780,4.4
17105,2017,16669,15920,749,4.5
17107,2017,12867,12272,595,4.6
17109,2017,13527,12845,682,5
17111,2017,166966,159616,7350,4.4
17113,2017,89332,85632,3700,4.1
17115,2017,49612,46851,2761,5.6
17117,2017,22985,21856,1129,4.9
17119,2017,134108,127724,6384,4.8
17121,2017,17686,16755,931,5.3
17123,2017,5457,5162,295,5.4
17125,2017,6425,6034,391,6.1
17127,2017,5850,5469,381,6.5
17129,2017,6541,6265,276,4.2
17131,2017,8070,7655,415,5.1
17133,2017,18478,17854,624,3.4
17135,2017,11938,11252,686,5.7
17137,2017,16438,15715,723,4.4
17139,2017,7334,7048,286,3.9
17141,2017,25397,24092,1305,5.1
17143,2017,86200,81123,5077,5.9
17145,2017,8403,7898,505,6
17147,2017,8537,8190,347,4.1
17149,2017,7291,6962,329,4.5
17151,2017,1779,1667,112,6.3
17153,2017,2125,1956,169,8
17155,2017,3005,2856,149,5
17157,2017,14186,13557,629,4.4
17159,2017,7550,7188,362,4.8
17161,2017,71245,67587,3658,5.1
17163,2017,126412,120017,6395,5.1
17165,2017,9773,9140,633,6.5
17167,2017,102259,97745,4514,4.4
17169,2017,3336,3184,152,4.6
17171,2017,2456,2327,129,5.3
17173,2017,10416,9953,463,4.4
17175,2017,2568,2405,163,6.3
17177,2017,21660,20642,1018,4.7
17179,2017,64655,61182,3473,5.4
17181,2017,7361,6886,475,6.5
17183,2017,33974,31766,2208,6.5
17185,2017,5633,5350,283,5
17187,2017,8661,8297,364,4.2
17189,2017,9640,9354,286,3
17191,2017,6954,6523,431,6.2
17193,2017,6679,6354,325,4.9
17195,2017,28199,26834,1365,4.8
17197,2017,359836,341728,18108,5
17199,2017,31820,30172,1648,5.2
17201,2017,139076,130081,8995,6.5
17203,2017,18935,18101,834,4.4
18001,2017,17259,16803,456,2.6
18003,2017,181214,175114,6100,3.4
18005,2017,44510,43280,1230,2.8
18007,2017,4497,4342,155,3.4
18009,2017,5341,5124,217,4.1
18011,2017,35397,34381,1016,2.9
18013,2017,7557,7297,260,3.4
18015,2017,10074,9725,349,3.5
18017,2017,17894,17204,690,3.9
18019,2017,60899,58750,2149,3.5
18021,2017,12287,11825,462,3.8
18023,2017,16979,16452,527,3.1
18025,2017,4948,4726,222,4.5
18027,2017,15944,15493,451,2.8
18029,2017,25762,24757,1005,3.9
18031,2017,14700,14266,434,3
18033,2017,22268,21610,658,3
18035,2017,54377,52034,2343,4.3
18037,2017,23202,22596,606,2.6
18039,2017,112354,109475,2879,2.6
18041,2017,9081,8620,461,5.1
18043,2017,40895,39517,1378,3.4
18045,2017,7913,7594,319,4
18047,2017,11220,10811,409,3.6
18049,2017,9768,9424,344,3.5
18051,2017,19111,18543,568,3
18053,2017,31859,30608,1251,3.9
18055,2017,13611,12960,651,4.8
18057,2017,178349,173395,4954,2.8
18059,2017,39147,37953,1194,3.1
18061,2017,19927,19227,700,3.5
18063,2017,87212,84659,2553,2.9
18065,2017,22183,21363,820,3.7
18067,2017,37983,36519,1464,3.9
18069,2017,18407,17743,664,3.6
18071,2017,22453,21776,677,3
18073,2017,16402,15687,715,4.4
18075,2017,9789,9440,349,3.6
18077,2017,15078,14513,565,3.7
18079,2017,13247,12738,509,3.8
18081,2017,80948,78529,2419,3
18083,2017,18631,17987,644,3.5
18085,2017,41576,40430,1146,2.8
18087,2017,19988,19473,515,2.6
18089,2017,230191,218323,11868,5.2
18091,2017,47827,45672,2155,4.5
18093,2017,20825,19901,924,4.4
18095,2017,58574,56219,2355,4
18097,2017,483607,465932,17675,3.7
18099,2017,23681,22948,733,3.1
18101,2017,5137,4982,155,3
18103,2017,15867,15239,628,4
18105,2017,68512,65998,2514,3.7
18107,2017,18993,18407,586,3.1
18109,2017,35875,34600,1275,3.6
18111,2017,7075,6733,342,4.8
18113,2017,23134,22414,720,3.1
18115,2017,3153,3037,116,3.7
18117,2017,8718,8369,349,4
18119,2017,9194,8790,404,4.4
18121,2017,7192,6901,291,4
18123,2017,9267,8909,358,3.9
18125,2017,6450,6233,217,3.4
18127,2017,85992,82467,3525,4.1
18129,2017,13537,13127,410,3
18131,2017,6382,6158,224,3.5
18133,2017,16599,15990,609,3.7
18135,2017,11738,11245,493,4.2
18137,2017,14070,13567,503,3.6
18139,2017,8933,8658,275,3.1
18141,2017,134644,129779,4865,3.6
18143,2017,10469,10068,401,3.8
18145,2017,22890,22120,770,3.4
18147,2017,10921,10552,369,3.4
18149,2017,10458,9993,465,4.4
18151,2017,19963,19376,587,2.9
18153,2017,8582,8198,384,4.5
18155,2017,4999,4797,202,4
18157,2017,95611,92504,3107,3.2
18159,2017,8546,8283,263,3.1
18161,2017,3611,3498,113,3.1
18163,2017,93726,90656,3070,3.3
18165,2017,7148,6759,389,5.4
18167,2017,48974,46891,2083,4.3
18169,2017,15134,14601,533,3.5
18171,2017,4092,3953,139,3.4
18173,2017,32670,31634,1036,3.2
18175,2017,13633,13122,511,3.7
18177,2017,30854,29686,1168,3.8
18179,2017,14120,13698,422,3
18181,2017,13351,12909,442,3.3
18183,2017,17284,16772,512,3
19001,2017,4113,3998,115,2.8
19003,2017,2121,2071,50,2.4
19005,2017,7477,7177,300,4
19007,2017,6003,5775,228,3.8
19009,2017,3140,3043,97,3.1
19011,2017,13287,12849,438,3.3
19013,2017,68063,65496,2567,3.8
19015,2017,14756,14393,363,2.5
19017,2017,13708,13323,385,2.8
19019,2017,11041,10687,354,3.2
19021,2017,11487,11187,300,2.6
19023,2017,7818,7536,282,3.6
19025,2017,4270,4139,131,3.1
19027,2017,10974,10721,253,2.3
19029,2017,7092,6836,256,3.6
19031,2017,10738,10425,313,2.9
19033,2017,23107,22396,711,3.1
19035,2017,6015,5863,152,2.5
19037,2017,6338,6135,203,3.2
19039,2017,4761,4612,149,3.1
19041,2017,8520,8200,320,3.8
19043,2017,10128,9726,402,4
19045,2017,23060,22118,942,4.1
19047,2017,8211,7873,338,4.1
19049,2017,46671,45671,1000,2.1
19051,2017,4242,4100,142,3.3
19053,2017,4255,4142,113,2.7
19055,2017,10447,10168,279,2.7
19057,2017,19545,18717,828,4.2
19059,2017,10051,9681,370,3.7
19061,2017,54245,52619,1626,3
19063,2017,5375,5203,172,3.2
19065,2017,10432,10050,382,3.7
19067,2017,8731,8449,282,3.2
19069,2017,5753,5595,158,2.7
19071,2017,3791,3691,100,2.6
19073,2017,5400,5251,149,2.8
19075,2017,6501,6311,190,2.9
19077,2017,5531,5352,179,3.2
19079,2017,7025,6797,228,3.2
19081,2017,6099,5940,159,2.6
19083,2017,8396,8126,270,3.2
19085,2017,7266,7065,201,2.8
19087,2017,9621,9332,289,3
19089,2017,5071,4917,154,3
19091,2017,5233,5073,160,3.1
19093,2017,4003,3909,94,2.3
19095,2017,10379,10106,273,2.6
19097,2017,10828,10459,369,3.4
19099,2017,19191,18588,603,3.1
19101,2017,9098,8816,282,3.1
19103,2017,84952,82832,2120,2.5
19105,2017,10464,10080,384,3.7
19107,2017,5168,4982,186,3.6
19109,2017,8696,8489,207,2.4
19111,2017,16130,15248,882,5.5
19113,2017,118183,114206,3977,3.4
19115,2017,6040,5841,199,3.3
19117,2017,4343,4220,123,2.8
19119,2017,6957,6835,122,1.8
19121,2017,8254,7955,299,3.6
19123,2017,11560,11187,373,3.2
19125,2017,17275,16818,457,2.6
19127,2017,18126,17291,835,4.6
19129,2017,7274,7072,202,2.8
19131,2017,5742,5619,123,2.1
19133,2017,4492,4328,164,3.7
19135,2017,3873,3725,148,3.8
19137,2017,4927,4771,156,3.2
19139,2017,21757,21039,718,3.3
19141,2017,7983,7790,193,2.4
19143,2017,3572,3497,75,2.1
19145,2017,6317,6069,248,3.9
19147,2017,4868,4737,131,2.7
19149,2017,14597,14247,350,2.4
19151,2017,4151,4051,100,2.4
19153,2017,258774,250800,7974,3.1
19155,2017,47306,45977,1329,2.8
19157,2017,10363,10037,326,3.1
19159,2017,2536,2458,78,3.1
19161,2017,5313,5162,151,2.8
19163,2017,85963,82814,3149,3.7
19165,2017,6645,6485,160,2.4
19167,2017,20246,19837,409,2
19169,2017,57045,55906,1139,2
19171,2017,9536,9204,332,3.5
19173,2017,3219,3147,72,2.2
19175,2017,6395,6196,199,3.1
19177,2017,3702,3588,114,3.1
19179,2017,17547,16747,800,4.6
19181,2017,27050,26301,749,2.8
19183,2017,12168,11809,359,3
19185,2017,2761,2676,85,3.1
19187,2017,19269,18545,724,3.8
19189,2017,5135,4972,163,3.2
19191,2017,11780,11417,363,3.1
19193,2017,54129,52403,1726,3.2
19195,2017,4182,4055,127,3
19197,2017,6495,6271,224,3.4
20001,2017,6271,5966,305,4.9
20003,2017,4144,3981,163,3.9
20005,2017,7017,6651,366,5.2
20007,2017,2442,2373,69,2.8
20009,2017,14016,13508,508,3.6
20011,2017,7003,6693,310,4.4
20013,2017,5316,5145,171,3.2
20015,2017,31613,30418,1195,3.8
20017,2017,1423,1386,37,2.6
20019,2017,1441,1373,68,4.7
20021,2017,10085,9690,395,3.9
20023,2017,1310,1276,34,2.6
20025,2017,1082,1055,27,2.5
20027,2017,3802,3660,142,3.7
20029,2017,3876,3709,167,4.3
20031,2017,4102,3886,216,5.3
20033,2017,903,877,26,2.9
20035,2017,16901,16257,644,3.8
20037,2017,19046,18244,802,4.2
20039,2017,1276,1236,40,3.1
20041,2017,9235,8882,353,3.8
20043,2017,4182,4036,146,3.5
20045,2017,65070,62984,2086,3.2
20047,2017,1508,1461,47,3.1
20049,2017,1183,1133,50,4.2
20051,2017,16921,16495,426,2.5
20053,2017,2705,2622,83,3.1
20055,2017,20032,19481,551,2.8
20057,2017,17753,17249,504,2.8
20059,2017,14124,13596,528,3.7
20061,2017,11454,10886,568,5
20063,2017,1419,1386,33,2.3
20065,2017,1110,1070,40,3.6
20067,2017,3456,3345,111,3.2
20069,2017,3394,3326,68,2
20071,2017,867,851,16,1.8
20073,2017,3205,3069,136,4.2
20075,2017,1626,1587,39,2.4
20077,2017,2635,2537,98,3.7
20079,2017,16788,16100,688,4.1
20081,2017,2221,2171,50,2.3
20083,2017,984,959,25,2.5
20085,2017,7196,6970,226,3.1
20087,2017,10153,9792,361,3.6
20089,2017,1298,1253,45,3.5
20091,2017,332693,322568,10125,3
20093,2017,2054,2003,51,2.5
20095,2017,3378,3253,125,3.7
20097,2017,1340,1306,34,2.5
20099,2017,10302,9835,467,4.5
20101,2017,782,756,26,3.3
20103,2017,36155,34734,1421,3.9
20105,2017,1678,1630,48,2.9
20107,2017,4391,4132,259,5.9
20109,2017,1667,1631,36,2.2
20111,2017,16725,16090,635,3.8
20113,2017,16244,15795,449,2.8
20115,2017,6238,6012,226,3.6
20117,2017,5459,5306,153,2.8
20119,2017,2268,2212,56,2.5
20121,2017,17261,16613,648,3.8
20123,2017,3431,3337,94,2.7
20125,2017,14923,14138,785,5.3
20127,2017,2983,2889,94,3.2
20129,2017,1193,1148,45,3.8
20131,2017,5550,5416,134,2.4
20133,2017,6022,5704,318,5.3
20135,2017,1352,1313,39,2.9
20137,2017,2801,2738,63,2.2
20139,2017,7924,7609,315,4
20141,2017,2005,1950,55,2.7
20143,2017,3043,2949,94,3.1
20145,2017,3017,2916,101,3.3
20147,2017,2798,2715,83,3
20149,2017,12150,11774,376,3.1
20151,2017,4931,4770,161,3.3
20153,2017,1449,1417,32,2.2
20155,2017,29913,28749,1164,3.9
20157,2017,2446,2377,69,2.8
20159,2017,5371,5198,173,3.2
20161,2017,35002,33931,1071,3.1
20163,2017,2484,2389,95,3.8
20165,2017,1644,1591,53,3.2
20167,2017,3491,3374,117,3.4
20169,2017,30489,29508,981,3.2
20171,2017,2838,2776,62,2.2
20173,2017,244473,234077,10396,4.3
20175,2017,9788,9445,343,3.5
20177,2017,90931,87588,3343,3.7
20179,2017,1366,1335,31,2.3
20181,2017,2883,2799,84,2.9
20183,2017,1962,1907,55,2.8
20185,2017,1994,1928,66,3.3
20187,2017,995,967,28,2.8
20189,2017,2659,2574,85,3.2
20191,2017,10667,10259,408,3.8
20193,2017,4236,4127,109,2.6
20195,2017,1430,1382,48,3.4
20197,2017,3628,3512,116,3.2
20199,2017,847,825,22,2.6
20201,2017,2942,2854,88,3
20203,2017,1166,1137,29,2.5
20205,2017,3975,3787,188,4.7
20207,2017,1584,1514,70,4.4
20209,2017,77120,73086,4034,5.2
21001,2017,7170,6735,435,6.1
21003,2017,8977,8606,371,4.1
21005,2017,11834,11350,484,4.1
21007,2017,3636,3357,279,7.7
21009,2017,19009,18128,881,4.6
21011,2017,4724,4349,375,7.9
21013,2017,8666,7978,688,7.9
21015,2017,69859,67153,2706,3.9
21017,2017,9887,9432,455,4.6
21019,2017,18308,16990,1318,7.2
21021,2017,12611,11970,641,5.1
21023,2017,3833,3609,224,5.8
21025,2017,3745,3415,330,8.800000000000001
21027,2017,8019,7537,482,6
21029,2017,41829,40053,1776,4.2
21031,2017,5187,4900,287,5.5
21033,2017,5339,5055,284,5.3
21035,2017,18792,17961,831,4.4
21037,2017,49860,47972,1888,3.8
21039,2017,2386,2220,166,7
21041,2017,5004,4771,233,4.7
21043,2017,9922,8942,980,9.9
21045,2017,6684,6359,325,4.9
21047,2017,24477,22967,1510,6.2
21049,2017,17281,16477,804,4.7
21051,2017,5361,4887,474,8.800000000000001
21053,2017,3862,3608,254,6.6
21055,2017,3982,3762,220,5.5
21057,2017,2940,2783,157,5.3
21059,2017,47934,45832,2102,4.4
21061,2017,4862,4568,294,6
21063,2017,2117,1891,226,10.7
21065,2017,5350,5028,322,6
21067,2017,175315,168917,6398,3.6
21069,2017,6064,5693,371,6.1
21071,2017,11280,10335,945,8.4
21073,2017,24772,23752,1020,4.1
21075,2017,2067,1917,150,7.3
21077,2017,4038,3854,184,4.6
21079,2017,7657,7283,374,4.9
21081,2017,11606,11037,569,4.9
21083,2017,15683,14741,942,6
21085,2017,10895,10228,667,6.1
21087,2017,5149,4909,240,4.7
21089,2017,13600,12550,1050,7.7
21091,2017,4104,3896,208,5.1
21093,2017,48741,46498,2243,4.6
21095,2017,6481,5833,648,10
21097,2017,8686,8283,403,4.6
21099,2017,8099,7738,361,4.5
21101,2017,21971,20967,1004,4.6
21103,2017,8133,7798,335,4.1
21105,2017,1820,1683,137,7.5
21107,2017,19474,18499,975,5
21109,2017,4103,3755,348,8.5
21111,2017,396486,378941,17545,4.4
21113,2017,26421,25415,1006,3.8
21115,2017,6922,6323,599,8.699999999999999
21117,2017,86597,83143,3454,4
21119,2017,4505,4120,385,8.5
21121,2017,10065,9297,768,7.6
21123,2017,6019,5733,286,4.8
21125,2017,24665,23211,1454,5.9
21127,2017,5006,4550,456,9.1
21129,2017,1897,1735,162,8.5
21131,2017,2736,2459,277,10.1
21133,2017,6298,5706,592,9.4
21135,2017,4707,4270,437,9.300000000000001
21137,2017,9375,8842,533,5.7
21139,2017,3758,3473,285,7.6
21141,2017,12162,11625,537,4.4
21143,2017,2993,2818,175,5.8
21145,2017,29670,27864,1806,6.1
21147,2017,4693,4368,325,6.9
21149,2017,4301,4070,231,5.4
21151,2017,46168,44181,1987,4.3
21153,2017,2994,2505,489,16.3
21155,2017,9461,9065,396,4.2
21157,2017,15038,14139,899,6
21159,2017,3076,2840,236,7.7
21161,2017,7225,6772,453,6.3
21163,2017,12234,11600,634,5.2
21165,2017,2368,2161,207,8.699999999999999
21167,2017,9978,9485,493,4.9
21169,2017,4180,4008,172,4.1
21171,2017,4727,4541,186,3.9
21173,2017,11734,10954,780,6.6
21175,2017,4510,4175,335,7.4
21177,2017,11248,10465,783,7
21179,2017,22280,21292,988,4.4
21181,2017,3315,3129,186,5.6
21183,2017,9790,9166,624,6.4
21185,2017,32919,31761,1158,3.5
21187,2017,5451,5210,241,4.4
21189,2017,1100,1008,92,8.4
21191,2017,6985,6654,331,4.7
21193,2017,8407,7706,701,8.300000000000001
21195,2017,20364,18777,1587,7.8
21197,2017,5028,4692,336,6.7
21199,2017,25392,23957,1435,5.7
21201,2017,818,767,51,6.2
21203,2017,6626,6239,387,5.8
21205,2017,10657,10036,621,5.8
21207,2017,6260,5811,449,7.2
21209,2017,28711,27653,1058,3.7
21211,2017,24702,23808,894,3.6
21213,2017,8731,8331,400,4.6
21215,2017,9948,9565,383,3.9
21217,2017,12871,12306,565,4.4
21219,2017,5326,5101,225,4.2
21221,2017,5945,5605,340,5.7
21223,2017,3884,3689,195,5
21225,2017,6105,5737,368,6
21227,2017,64010,61403,2607,4.1
21229,2017,6179,5919,260,4.2
21231,2017,7411,6833,578,7.8
21233,2017,5808,5504,304,5.2
21235,2017,13764,12966,798,5.8
21237,2017,1927,1750,177,9.199999999999999
21239,2017,14963,14474,489,3.3
22001,2017,24008,22590,1418,5.9
22003,2017,8966,8494,472,5.3
22005,2017,62727,60050,2677,4.3
22007,2017,8932,8276,656,7.3
22009,2017,15600,14644,956,6.1
22011,2017,14654,13871,783,5.3
22013,2017,5628,5291,337,6
22015,2017,57569,55002,2567,4.5
22017,2017,104766,98703,6063,5.8
22019,2017,108343,104053,4290,4
22021,2017,3855,3635,220,5.7
22023,2017,4002,3858,144,3.6
22025,2017,3431,3189,242,7.1
22027,2017,5853,5540,313,5.3
22029,2017,7147,6586,561,7.8
22031,2017,10773,10120,653,6.1
22033,2017,231574,221405,10169,4.4
22035,2017,2053,1825,228,11.1
22037,2017,7971,7589,382,4.8
22039,2017,12529,11789,740,5.9
22041,2017,7300,6755,545,7.5
22043,2017,8177,7662,515,6.3
22045,2017,28915,26803,2112,7.3
22047,2017,14143,13272,871,6.2
22049,2017,6978,6662,316,4.5
22051,2017,214803,205071,9732,4.5
22053,2017,13609,12946,663,4.9
22055,2017,113004,107484,5520,4.9
22057,2017,41890,39713,2177,5.2
22059,2017,6137,5849,288,4.7
22061,2017,21542,20428,1114,5.2
22063,2017,67654,64801,2853,4.2
22065,2017,3776,3470,306,8.1
22067,2017,10351,9526,825,8
22069,2017,16327,15351,976,6
22071,2017,178474,169295,9179,5.1
22073,2017,70556,66848,3708,5.3
22075,2017,10002,9536,466,4.7
22077,2017,9989,9431,558,5.6
22079,2017,56029,52885,3144,5.6
22081,2017,3855,3655,200,5.2
22083,2017,8307,7798,509,6.1
22085,2017,8819,8334,485,5.5
22087,2017,19498,18477,1021,5.2
22089,2017,24880,23760,1120,4.5
22091,2017,4312,4026,286,6.6
22093,2017,9372,8749,623,6.6
22095,2017,19697,18487,1210,6.1
22097,2017,32031,29894,2137,6.7
22099,2017,22515,21148,1367,6.1
22101,2017,20345,18745,1600,7.9
22103,2017,117309,112291,5018,4.3
22105,2017,54760,51638,3122,5.7
22107,2017,1550,1419,131,8.5
22109,2017,46701,44045,2656,5.7
22111,2017,9191,8681,510,5.5
22113,2017,24200,22750,1450,6
22115,2017,16354,15290,1064,6.5
22117,2017,16910,15934,976,5.8
22119,2017,14747,13736,1011,6.9
22121,2017,13474,12856,618,4.6
22123,2017,3995,3604,391,9.800000000000001
22125,2017,5323,5101,222,4.2
22127,2017,5047,4722,325,6.4
23001,2017,55498,53719,1779,3.2
23003,2017,31496,29946,1550,4.9
23005,2017,164393,160092,4301,2.6
23007,2017,14430,13832,598,4.1
23009,2017,29297,28147,1150,3.9
23011,2017,62653,60575,2078,3.3
23013,2017,20706,20038,668,3.2
23015,2017,17034,16470,564,3.3
23017,2017,26808,25770,1038,3.9
23019,2017,76886,73943,2943,3.8
23021,2017,7494,7187,307,4.1
23023,2017,19379,18844,535,2.8
23025,2017,23053,21906,1147,5
23027,2017,21145,20364,781,3.7
23029,2017,14039,13330,709,5.1
23031,2017,113240,109842,3398,3
24001,2017,32285,30384,1901,5.9
24003,2017,309762,298524,11238,3.6
24005,2017,451094,431131,19963,4.4
24009,2017,49408,47580,1828,3.7
24011,2017,17996,17210,786,4.4
24013,2017,94284,91030,3254,3.5
24015,2017,52942,50350,2592,4.9
24017,2017,85739,82251,3488,4.1
24019,2017,15668,14754,914,5.8
24021,2017,130982,126096,4886,3.7
24023,2017,15521,14697,824,5.3
24025,2017,138436,132941,5495,4
24027,2017,183757,177894,5863,3.2
24029,2017,10243,9777,466,4.5
24031,2017,554246,535516,18730,3.4
24033,2017,507781,486103,21678,4.3
24035,2017,27390,26367,1023,3.7
24037,2017,55146,52904,2242,4.1
24039,2017,9300,8649,651,7
24041,2017,19724,18926,798,4
24043,2017,75360,71778,3582,4.8
24045,2017,50920,47945,2975,5.8
24047,2017,25473,23245,2228,8.699999999999999
24510,2017,291127,272834,18293,6.3
25001,2017,113143,107842,5301,4.7
25003,2017,64805,61939,2866,4.4
25005,2017,296135,282014,14121,4.8
25007,2017,9544,9076,468,4.9
25009,2017,417879,401927,15952,3.8
25011,2017,40280,38925,1355,3.4
25013,2017,225203,213721,11482,5.1
25015,2017,89070,85984,3086,3.5
25017,2017,892592,865126,27466,3.1
25019,2017,7195,6874,321,4.5
25021,2017,379497,366819,12678,3.3
25023,2017,275591,264740,10851,3.9
25025,2017,440368,425335,15033,3.4
25027,2017,438265,421065,17200,3.9
26001,2017,3833,3561,272,7.1
26003,2017,3285,3014,271,8.199999999999999
26005,2017,61124,58838,2286,3.7
26007,2017,13591,12819,772,5.7
26009,2017,10057,9401,656,6.5
26011,2017,6013,5531,482,8
26013,2017,3173,2929,244,7.7
26015,2017,31233,30014,1219,3.9
26017,2017,50845,48066,2779,5.5
26019,2017,8829,8259,570,6.5
26021,2017,73938,70391,3547,4.8
26023,2017,19208,18333,875,4.6
26025,2017,63848,60757,3091,4.8
26027,2017,24252,23150,1102,4.5
26029,2017,13051,12329,722,5.5
26031,2017,10789,9718,1071,9.9
26033,2017,16325,15084,1241,7.6
26035,2017,11938,11113,825,6.9
26037,2017,40900,39428,1472,3.6
26039,2017,5407,5035,372,6.9
26041,2017,17020,15960,1060,6.2
26043,2017,12527,11941,586,4.7
26045,2017,57162,54842,2320,4.1
26047,2017,17617,16479,1138,6.5
26049,2017,182159,171986,10173,5.6
26051,2017,9872,9234,638,6.5
26053,2017,6304,5931,373,5.9
26055,2017,49242,47194,2048,4.2
26057,2017,17818,16859,959,5.4
26059,2017,20887,19872,1015,4.9
26061,2017,16437,15470,967,5.9
26063,2017,15581,14784,797,5.1
26065,2017,150953,144547,6406,4.2
26067,2017,29780,28615,1165,3.9
26069,2017,10114,9376,738,7.3
26071,2017,5155,4828,327,6.3
26073,2017,35109,33550,1559,4.4
26075,2017,74225,70836,3389,4.6
26077,2017,132575,127306,5269,4
26079,2017,7869,7329,540,6.9
26081,2017,355010,342863,12147,3.4
26083,2017,899,821,78,8.699999999999999
26085,2017,3720,3419,301,8.1
26087,2017,40961,38687,2274,5.6
26089,2017,10483,9984,499,4.8
26091,2017,47053,44858,2195,4.7
26093,2017,101753,98273,3480,3.4
26095,2017,2409,2246,163,6.8
26097,2017,5188,4667,521,10
26099,2017,442784,423189,19595,4.4
26101,2017,10403,9732,671,6.5
26103,2017,32847,31032,1815,5.5
26105,2017,14008,13211,797,5.7
26107,2017,18766,17703,1063,5.7
26109,2017,10982,10454,528,4.8
26111,2017,40475,38616,1859,4.6
26113,2017,6908,6507,401,5.8
26115,2017,75940,72370,3570,4.7
26117,2017,28112,26722,1390,4.9
26119,2017,3053,2737,316,10.4
26121,2017,77760,73660,4100,5.3
26123,2017,23250,22113,1137,4.9
26125,2017,665406,641783,23623,3.6
26127,2017,12199,11342,857,7
26129,2017,8164,7543,621,7.6
26131,2017,2163,1974,189,8.699999999999999
26133,2017,10611,9983,628,5.9
26135,2017,2908,2696,212,7.3
26137,2017,11639,10947,692,5.9
26139,2017,157861,152735,5126,3.2
26141,2017,5163,4688,475,9.199999999999999
26143,2017,7825,7140,685,8.800000000000001
26145,2017,87634,82954,4680,5.3
26147,2017,75211,71343,3868,5.1
26149,2017,28680,27484,1196,4.2
26151,2017,19272,18149,1123,5.8
26153,2017,3355,3078,277,8.300000000000001
26155,2017,33371,31670,1701,5.1
26157,2017,23925,22452,1473,6.2
26159,2017,35236,33249,1987,5.6
26161,2017,193957,187194,6763,3.5
26163,2017,791967,747804,44163,5.6
26165,2017,14752,13936,816,5.5
27001,2017,7174,6734,440,6.1
27003,2017,195325,188903,6422,3.3
27005,2017,18564,17802,762,4.1
27007,2017,23654,22518,1136,4.8
27009,2017,21736,20869,867,4
27011,2017,2571,2459,112,4.4
27013,2017,40034,38886,1148,2.9
27015,2017,14382,13856,526,3.7
27017,2017,17692,16866,826,4.7
27019,2017,57430,55780,1650,2.9
27021,2017,14343,13503,840,5.9
27023,2017,6925,6655,270,3.9
27025,2017,29483,28331,1152,3.9
27027,2017,35669,34540,1129,3.2
27029,2017,4599,4201,398,8.699999999999999
27031,2017,3108,2991,117,3.8
27033,2017,5716,5423,293,5.1
27035,2017,32209,30796,1413,4.4
27037,2017,238085,230989,7096,3
27039,2017,11702,11313,389,3.3
27041,2017,20534,19891,643,3.1
27043,2017,7139,6846,293,4.1
27045,2017,11415,11020,395,3.5
27047,2017,16147,15567,580,3.6
27049,2017,26854,26001,853,3.2
27051,2017,3282,3149,133,4.1
27053,2017,698627,677806,20821,3
27055,2017,10458,10104,354,3.4
27057,2017,9820,9276,544,5.5
27059,2017,20998,20108,890,4.2
27061,2017,21732,20241,1491,6.9
27063,2017,5757,5551,206,3.6
27065,2017,9031,8489,542,6
27067,2017,24838,24041,797,3.2
27069,2017,2367,2280,87,3.7
27071,2017,5970,5553,417,7
27073,2017,3524,3404,120,3.4
27075,2017,5506,5297,209,3.8
27077,2017,2384,2274,110,4.6
27079,2017,15854,15125,729,4.6
27081,2017,3358,3252,106,3.2
27083,2017,14969,14498,471,3.1
27085,2017,19508,18778,730,3.7
27087,2017,2361,2244,117,5
27089,2017,5474,5100,374,6.8
27091,2017,10411,10058,353,3.4
27093,2017,13243,12715,528,4
27095,2017,12724,12028,696,5.5
27097,2017,17663,16736,927,5.2
27099,2017,20566,19995,571,2.8
27101,2017,4885,4673,212,4.3
27103,2017,20620,20106,514,2.5
27105,2017,11343,10988,355,3.1
27107,2017,3396,3239,157,4.6
27109,2017,86732,84431,2301,2.7
27111,2017,31540,30306,1234,3.9
27113,2017,8795,8304,491,5.6
27115,2017,14983,14141,842,5.6
27117,2017,4859,4699,160,3.3
27119,2017,16994,16291,703,4.1
27121,2017,6360,6168,192,3
27123,2017,286896,277771,9125,3.2
27125,2017,2251,2104,147,6.5
27127,2017,7676,7368,308,4
27129,2017,8880,8493,387,4.4
27131,2017,36535,35393,1142,3.1
27133,2017,5875,5754,121,2.1
27135,2017,8141,7749,392,4.8
27137,2017,102524,97860,4664,4.5
27139,2017,82152,79809,2343,2.9
27141,2017,51370,49480,1890,3.7
27143,2017,8413,8116,297,3.5
27145,2017,90072,87070,3002,3.3
27147,2017,20536,19855,681,3.3
27149,2017,5508,5364,144,2.6
27151,2017,5049,4845,204,4
27153,2017,13500,12976,524,3.9
27155,2017,1772,1710,62,3.5
27157,2017,12164,11764,400,3.3
27159,2017,5831,5511,320,5.5
27161,2017,9296,8940,356,3.8
27163,2017,140943,136786,4157,2.9
27165,2017,6499,6223,276,4.2
27167,2017,3553,3444,109,3.1
27169,2017,28973,28089,884,3.1
27171,2017,74182,71611,2571,3.5
27173,2017,5353,5170,183,3.4
28001,2017,11244,10424,820,7.3
28003,2017,16063,15353,710,4.4
28005,2017,4469,4166,303,6.8
28007,2017,6970,6549,421,6
28009,2017,3040,2870,170,5.6
28011,2017,12916,12087,829,6.4
28013,2017,5640,5376,264,4.7
28015,2017,3540,3333,207,5.8
28017,2017,7079,6709,370,5.2
28019,2017,3623,3443,180,5
28021,2017,3029,2733,296,9.800000000000001
28023,2017,6167,5796,371,6
28025,2017,7749,7223,526,6.8
28027,2017,8632,7989,643,7.4
28029,2017,11268,10626,642,5.7
28031,2017,8116,7723,393,4.8
28033,2017,88831,85421,3410,3.8
28035,2017,33524,31900,1624,4.8
28037,2017,2866,2671,195,6.8
28039,2017,8849,8215,634,7.2
28041,2017,4382,4054,328,7.5
28043,2017,9664,9221,443,4.6
28045,2017,18757,17714,1043,5.6
28047,2017,86244,82053,4191,4.9
28049,2017,109419,104106,5313,4.9
28051,2017,5826,5278,548,9.4
28053,2017,2207,1998,209,9.5
28055,2017,392,345,47,12
28057,2017,10534,10092,442,4.2
28059,2017,58609,55136,3473,5.9
28061,2017,6094,5695,399,6.5
28063,2017,2122,1812,310,14.6
28065,2017,4243,3954,289,6.8
28067,2017,25449,24132,1317,5.2
28069,2017,3600,3320,280,7.8
28071,2017,27579,26435,1144,4.1
28073,2017,30223,29067,1156,3.8
28075,2017,31844,30149,1695,5.3
28077,2017,4694,4388,306,6.5
28079,2017,7604,7168,436,5.7
28081,2017,41205,39555,1650,4
28083,2017,10148,9392,756,7.4
28085,2017,14570,13813,757,5.2
28087,2017,25338,23979,1359,5.4
28089,2017,53314,51244,2070,3.9
28091,2017,10217,9655,562,5.5
28093,2017,14405,13661,744,5.2
28095,2017,15603,14799,804,5.2
28097,2017,4169,3957,212,5.1
28099,2017,10403,9865,538,5.2
28101,2017,8935,8481,454,5.1
28103,2017,3907,3621,286,7.3
28105,2017,22268,21160,1108,5
28107,2017,13080,12200,880,6.7
28109,2017,23492,22256,1236,5.3
28111,2017,4328,4054,274,6.3
28113,2017,14492,13611,881,6.1
28115,2017,14681,14115,566,3.9
28117,2017,11224,10713,511,4.6
28119,2017,2433,2216,217,8.9
28121,2017,76182,73456,2726,3.6
28123,2017,13051,12512,539,4.1
28125,2017,1616,1487,129,8
28127,2017,10958,10423,535,4.9
28129,2017,6767,6447,320,4.7
28131,2017,6583,6180,403,6.1
28133,2017,7969,7306,663,8.300000000000001
28135,2017,5483,5189,294,5.4
28137,2017,12117,11502,615,5.1
28139,2017,9479,9056,423,4.5
28141,2017,8368,7954,414,4.9
28143,2017,4460,4195,265,5.9
28145,2017,14006,13501,505,3.6
28147,2017,5069,4727,342,6.7
28149,2017,20881,19704,1177,5.6
28151,2017,17781,16509,1272,7.2
28153,2017,7400,6930,470,6.4
28155,2017,3881,3677,204,5.3
28157,2017,2835,2585,250,8.800000000000001
28159,2017,7228,6792,436,6
28161,2017,5084,4808,276,5.4
28163,2017,9102,8547,555,6.1
29001,2017,10495,10049,446,4.2
29003,2017,9814,9502,312,3.2
29005,2017,2857,2758,99,3.5
29007,2017,11100,10716,384,3.5
29009,2017,15511,14995,516,3.3
29011,2017,5213,4997,216,4.1
29013,2017,7988,7634,354,4.4
29015,2017,7297,6928,369,5.1
29017,2017,5507,5266,241,4.4
29019,2017,97546,94997,2549,2.6
29021,2017,45168,43570,1598,3.5
29023,2017,18547,17713,834,4.5
29025,2017,4435,4256,179,4
29027,2017,21476,20731,745,3.5
29029,2017,18919,18019,900,4.8
29031,2017,39910,38531,1379,3.5
29033,2017,4794,4601,193,4
29035,2017,2536,2388,148,5.8
29037,2017,54292,52392,1900,3.5
29039,2017,5765,5532,233,4
29041,2017,3858,3725,133,3.4
29043,2017,43259,41924,1335,3.1
29045,2017,3211,3032,179,5.6
29047,2017,134965,130101,4864,3.6
29049,2017,10891,10460,431,4
29051,2017,38867,37730,1137,2.9
29053,2017,7472,7202,270,3.6
29055,2017,10826,10330,496,4.6
29057,2017,3581,3460,121,3.4
29059,2017,6954,6628,326,4.7
29061,2017,4082,3947,135,3.3
29063,2017,4914,4724,190,3.9
29065,2017,6188,5930,258,4.2
29067,2017,5079,4846,233,4.6
29069,2017,12454,11650,804,6.5
29071,2017,52531,50641,1890,3.6
29073,2017,7801,7503,298,3.8
29075,2017,3628,3526,102,2.8
29077,2017,147265,142759,4506,3.1
29079,2017,4810,4639,171,3.6
29081,2017,3926,3789,137,3.5
29083,2017,9911,9506,405,4.1
29085,2017,3768,3601,167,4.4
29087,2017,2698,2621,77,2.9
29089,2017,5090,4897,193,3.8
29091,2017,15936,15183,753,4.7
29093,2017,3590,3360,230,6.4
29095,2017,363006,347100,15906,4.4
29097,2017,56919,55007,1912,3.4
29099,2017,116554,112409,4145,3.6
29101,2017,23329,22310,1019,4.4
29103,2017,1996,1932,64,3.2
29105,2017,16639,15854,785,4.7
29107,2017,17014,16375,639,3.8
29109,2017,17897,17267,630,3.5
29111,2017,5122,4947,175,3.4
29113,2017,27431,26453,978,3.6
29115,2017,5272,4967,305,5.8
29117,2017,7478,7259,219,2.9
29119,2017,10414,10036,378,3.6
29121,2017,7594,7322,272,3.6
29123,2017,5504,5258,246,4.5
29125,2017,3926,3758,168,4.3
29127,2017,14574,14055,519,3.6
29129,2017,1949,1877,72,3.7
29131,2017,12044,11512,532,4.4
29133,2017,6064,5762,302,5
29135,2017,7377,7111,266,3.6
29137,2017,4078,3904,174,4.3
29139,2017,5666,5481,185,3.3
29141,2017,7958,7570,388,4.9
29143,2017,8019,7494,525,6.5
29145,2017,27399,26407,992,3.6
29147,2017,10668,10288,380,3.6
29149,2017,4025,3841,184,4.6
29151,2017,7132,6920,212,3
29153,2017,3576,3369,207,5.8
29155,2017,6572,6085,487,7.4
29157,2017,10134,9866,268,2.6
29159,2017,20917,20052,865,4.1
29161,2017,19741,19009,732,3.7
29163,2017,7950,7678,272,3.4
29165,2017,57782,55951,1831,3.2
29167,2017,14224,13660,564,4
29169,2017,14743,14116,627,4.3
29171,2017,2452,2359,93,3.8
29173,2017,5660,5485,175,3.1
29175,2017,10297,9834,463,4.5
29177,2017,11120,10587,533,4.8
29179,2017,3136,3015,121,3.9
29181,2017,5261,4971,290,5.5
29183,2017,222425,216099,6326,2.8
29185,2017,3890,3693,197,5.1
29186,2017,9113,8788,325,3.6
29187,2017,26794,25629,1165,4.3
29189,2017,526669,508640,18029,3.4
29195,2017,10701,10323,378,3.5
29197,2017,1962,1867,95,4.8
29199,2017,2459,2382,77,3.1
29201,2017,20167,19277,890,4.4
29203,2017,3290,3092,198,6
29205,2017,3101,2996,105,3.4
29207,2017,13264,12599,665,5
29209,2017,13857,13096,761,5.5
29211,2017,2760,2649,111,4
29213,2017,27006,25390,1616,6
29215,2017,9394,8932,462,4.9
29217,2017,9673,9308,365,3.8
29219,2017,17618,17058,560,3.2
29221,2017,10329,9775,554,5.4
29223,2017,5552,5272,280,5
29225,2017,16866,16216,650,3.9
29227,2017,1194,1164,30,2.5
29229,2017,7633,7258,375,4.9
29510,2017,154436,147604,6832,4.4
30001,2017,5054,4900,154,3
30003,2017,5519,4792,727,13.2
30005,2017,2355,2261,94,4
30007,2017,2587,2467,120,4.6
30009,2017,5506,5310,196,3.6
30011,2017,696,679,17,2.4
30013,2017,37801,36409,1392,3.7
30015,2017,2495,2414,81,3.2
30017,2017,6166,5976,190,3.1
30019,2017,908,888,20,2.2
30021,2017,4683,4542,141,3
30023,2017,5140,4961,179,3.5
30025,2017,1738,1693,45,2.6
30027,2017,5767,5540,227,3.9
30029,2017,46813,44406,2407,5.1
30031,2017,64606,62858,1748,2.7
30033,2017,761,740,21,2.8
30035,2017,5726,5280,446,7.8
30037,2017,373,355,18,4.8
30039,2017,1619,1526,93,5.7
30041,2017,7800,7511,289,3.7
30043,2017,5631,5394,237,4.2
30045,2017,924,891,33,3.6
30047,2017,13149,12573,576,4.4
30049,2017,35293,34099,1194,3.4
30051,2017,980,951,29,3
30053,2017,7898,7243,655,8.300000000000001
30055,2017,1023,1002,21,2.1
30057,2017,4397,4229,168,3.8
30059,2017,931,891,40,4.3
30061,2017,1687,1563,124,7.4
30063,2017,62402,60192,2210,3.5
30065,2017,2291,2191,100,4.4
30067,2017,8632,8301,331,3.8
30069,2017,292,280,12,4.1
30071,2017,1893,1809,84,4.4
30073,2017,2743,2640,103,3.8
30075,2017,1007,982,25,2.5
30077,2017,2891,2768,123,4.3
30079,2017,487,469,18,3.7
30081,2017,19788,18881,907,4.6
30083,2017,5978,5758,220,3.7
30085,2017,4572,4364,208,4.5
30087,2017,4024,3821,203,5
30089,2017,4783,4456,327,6.8
30091,2017,1865,1816,49,2.6
30093,2017,17157,16452,705,4.1
30095,2017,4847,4664,183,3.8
30097,2017,1798,1743,55,3.1
30099,2017,2783,2676,107,3.8
30101,2017,2152,2088,64,3
30103,2017,341,328,13,3.8
30105,2017,4163,4030,133,3.2
30107,2017,785,751,34,4.3
30109,2017,483,468,15,3.1
30111,2017,81390,78600,2790,3.4
31001,2017,16592,16081,511,3.1
31003,2017,3557,3469,88,2.5
31005,2017,219,207,12,5.5
31007,2017,389,375,14,3.6
31009,2017,261,250,11,4.2
31011,2017,2924,2853,71,2.4
31013,2017,5417,5240,177,3.3
31015,2017,1078,1042,36,3.3
31017,2017,1399,1354,45,3.2
31019,2017,27227,26571,656,2.4
31021,2017,3499,3371,128,3.7
31023,2017,4556,4430,126,2.8
31025,2017,13144,12731,413,3.1
31027,2017,4463,4364,99,2.2
31029,2017,2301,2258,43,1.9
31031,2017,3387,3309,78,2.3
31033,2017,5090,4945,145,2.8
31035,2017,3271,3170,101,3.1
31037,2017,5589,5455,134,2.4
31039,2017,4722,4595,127,2.7
31041,2017,6374,6238,136,2.1
31043,2017,10613,10185,428,4
31045,2017,5153,5013,140,2.7
31047,2017,12917,12549,368,2.8
31049,2017,1034,1008,26,2.5
31051,2017,3010,2917,93,3.1
31053,2017,19323,18784,539,2.8
31055,2017,290548,281350,9198,3.2
31057,2017,1179,1151,28,2.4
31059,2017,3100,3023,77,2.5
31061,2017,1474,1430,44,3
31063,2017,1558,1519,39,2.5
31065,2017,2674,2609,65,2.4
31067,2017,10940,10561,379,3.5
31069,2017,1187,1154,33,2.8
31071,2017,1155,1125,30,2.6
31073,2017,1043,1015,28,2.7
31075,2017,438,428,10,2.3
31077,2017,1219,1182,37,3
31079,2017,31536,30461,1075,3.4
31081,2017,4673,4557,116,2.5
31083,2017,1770,1725,45,2.5
31085,2017,571,557,14,2.5
31087,2017,1261,1218,43,3.4
31089,2017,5742,5603,139,2.4
31091,2017,395,380,15,3.8
31093,2017,3312,3212,100,3
31095,2017,4190,4089,101,2.4
31097,2017,2072,2002,70,3.4
31099,2017,3749,3667,82,2.2
31101,2017,4582,4444,138,3
31103,2017,605,590,15,2.5
31105,2017,1970,1914,56,2.8
31107,2017,4682,4522,160,3.4
31109,2017,170251,165762,4489,2.6
31111,2017,18420,17863,557,3
31113,2017,470,457,13,2.8
31115,2017,398,386,12,3
31117,2017,452,442,10,2.2
31119,2017,19222,18721,501,2.6
31121,2017,4047,3935,112,2.8
31123,2017,2602,2525,77,3
31125,2017,2015,1965,50,2.5
31127,2017,3597,3458,139,3.9
31129,2017,2357,2295,62,2.6
31131,2017,8142,7872,270,3.3
31133,2017,1501,1456,45,3
31135,2017,1803,1769,34,1.9
31137,2017,4896,4784,112,2.3
31139,2017,4109,3999,110,2.7
31141,2017,17216,16725,491,2.9
31143,2017,2888,2820,68,2.4
31145,2017,5830,5683,147,2.5
31147,2017,4205,4069,136,3.2
31149,2017,902,879,23,2.5
31151,2017,7382,7156,226,3.1
31153,2017,93021,90440,2581,2.8
31155,2017,10818,10517,301,2.8
31157,2017,18352,17727,625,3.4
31159,2017,8600,8370,230,2.7
31161,2017,2710,2639,71,2.6
31163,2017,1690,1642,48,2.8
31165,2017,754,732,22,2.9
31167,2017,3470,3373,97,2.8
31169,2017,2857,2793,64,2.2
31171,2017,435,421,14,3.2
31173,2017,3007,2859,148,4.9
31175,2017,2107,2052,55,2.6
31177,2017,11124,10781,343,3.1
31179,2017,5644,5510,134,2.4
31181,2017,1659,1611,48,2.9
31183,2017,582,569,13,2.2
31185,2017,7316,7130,186,2.5
32001,2017,10560,10091,469,4.4
32003,2017,1072743,1016808,55935,5.2
32005,2017,22453,21371,1082,4.8
32007,2017,26869,25879,990,3.7
32009,2017,486,466,20,4.1
32011,2017,1048,1016,32,3.1
32013,2017,8076,7735,341,4.2
32015,2017,3119,2978,141,4.5
32017,2017,2019,1923,96,4.8
32019,2017,21723,20420,1303,6
32021,2017,1985,1877,108,5.4
32023,2017,16170,15132,1038,6.4
32027,2017,2547,2431,116,4.6
32029,2017,1920,1824,96,5
32031,2017,239139,229233,9906,4.1
32033,2017,4472,4292,180,4
32510,2017,25427,24153,1274,5
33001,2017,31126,30295,831,2.7
33003,2017,23569,22935,634,2.7
33005,2017,40986,39915,1071,2.6
33007,2017,14470,13967,503,3.5
33009,2017,49321,48232,1089,2.2
33011,2017,234126,227400,6726,2.9
33013,2017,82089,80129,1960,2.4
33015,2017,183194,177806,5388,2.9
33017,2017,72549,70794,1755,2.4
33019,2017,23253,22733,520,2.2
34001,2017,118514,109953,8561,7.2
34003,2017,475764,457269,18495,3.9
34005,2017,229971,220557,9414,4.1
34007,2017,252989,240117,12872,5.1
34009,2017,46047,41812,4235,9.199999999999999
34011,2017,65243,60702,4541,7
34013,2017,367815,347042,20773,5.6
34015,2017,149033,141994,7039,4.7
34017,2017,360525,344859,15666,4.3
34019,2017,63549,61304,2245,3.5
34021,2017,197039,188988,8051,4.1
34023,2017,436049,418216,17833,4.1
34025,2017,324012,310646,13366,4.1
34027,2017,255094,245814,9280,3.6
34029,2017,267817,254946,12871,4.8
34031,2017,241533,227728,13805,5.7
34033,2017,29163,27367,1796,6.2
34035,2017,170551,164062,6489,3.8
34037,2017,73275,70045,3230,4.4
34039,2017,275131,262077,13054,4.7
34041,2017,55567,53243,2324,4.2
35001,2017,327461,310374,17087,5.2
35003,2017,1159,1082,77,6.6
35005,2017,27369,25691,1678,6.1
35006,2017,9071,8400,671,7.4
35007,2017,5671,5347,324,5.7
35009,2017,22218,21203,1015,4.6
35011,2017,846,809,37,4.4
35013,2017,95419,89235,6184,6.5
35015,2017,29070,27623,1447,5
35017,2017,12204,11497,707,5.8
35019,2017,1638,1536,102,6.2
35021,2017,281,264,17,6
35023,2017,2124,2021,103,4.8
35025,2017,27733,26002,1731,6.2
35027,2017,8685,8228,457,5.3
35028,2017,9100,8766,334,3.7
35029,2017,10474,9069,1405,13.4
35031,2017,24191,22202,1989,8.199999999999999
35033,2017,2200,2033,167,7.6
35035,2017,24863,23415,1448,5.8
35037,2017,3242,3052,190,5.9
35039,2017,16734,15714,1020,6.1
35041,2017,7971,7576,395,5
35043,2017,64348,60568,3780,5.9
35045,2017,53757,49896,3861,7.2
35047,2017,10930,10157,773,7.1
35049,2017,73231,69681,3550,4.8
35051,2017,4153,3844,309,7.4
35053,2017,6575,6174,401,6.1
35055,2017,15024,13891,1133,7.5
35057,2017,5561,5106,455,8.199999999999999
35059,2017,1907,1839,68,3.6
35061,2017,30053,28149,1904,6.3
36001,2017,158138,151479,6659,4.2
36003,2017,19695,18395,1300,6.6
36005,2017,605491,567233,38258,6.3
36007,2017,84531,79840,4691,5.5
36009,2017,34282,32162,2120,6.2
36011,2017,35875,34077,1798,5
36013,2017,55433,52119,3314,6
36015,2017,35667,33705,1962,5.5
36017,2017,22331,21141,1190,5.3
36019,2017,36139,34239,1900,5.3
36021,2017,31107,29931,1176,3.8
36023,2017,22952,21630,1322,5.8
36025,2017,18962,17917,1045,5.5
36027,2017,143315,137197,6118,4.3
36029,2017,444145,421301,22844,5.1
36031,2017,17163,16226,937,5.5
36033,2017,19747,18554,1193,6
36035,2017,23158,21826,1332,5.8
36037,2017,29531,28123,1408,4.8
36039,2017,20509,19443,1066,5.2
36041,2017,2316,2145,171,7.4
36043,2017,28021,26428,1593,5.7
36045,2017,44993,42071,2922,6.5
36047,2017,1209284,1152039,57245,4.7
36049,2017,11599,10831,768,6.6
36051,2017,30639,29101,1538,5
36053,2017,32385,30604,1781,5.5
36055,2017,361957,344172,17785,4.9
36057,2017,22523,21240,1283,5.7
36059,2017,706396,677660,28736,4.1
36061,2017,916625,878936,37689,4.1
36063,2017,99442,93300,6142,6.2
36065,2017,101766,96696,5070,5
36067,2017,219720,209472,10248,4.7
36069,2017,54838,52384,2454,4.5
36071,2017,180708,172521,8187,4.5
36073,2017,17522,16491,1031,5.9
36075,2017,52710,49308,3402,6.5
36077,2017,28022,26621,1401,5
36079,2017,50861,48730,2131,4.2
36081,2017,1159130,1112183,46947,4.1
36083,2017,80979,77395,3584,4.4
36085,2017,220272,209939,10333,4.7
36087,2017,153519,146878,6641,4.3
36089,2017,43315,40431,2884,6.7
36091,2017,118282,113595,4687,4
36093,2017,75900,72511,3389,4.5
36095,2017,14664,13864,800,5.5
36097,2017,8211,7736,475,5.8
36099,2017,16073,15343,730,4.5
36101,2017,42668,40231,2437,5.7
36103,2017,776679,741944,34735,4.5
36105,2017,34296,32621,1675,4.9
36107,2017,22745,21580,1165,5.1
36109,2017,49912,47752,2160,4.3
36111,2017,88041,84047,3994,4.5
36113,2017,31841,30168,1673,5.3
36115,2017,28128,26823,1305,4.6
36117,2017,43657,41495,2162,5
36119,2017,480739,459137,21602,4.5
36121,2017,17907,16903,1004,5.6
36123,2017,11622,11114,508,4.4
37001,2017,79952,76587,3365,4.2
37003,2017,17977,17329,648,3.6
37005,2017,4363,4144,219,5
37007,2017,10526,9988,538,5.1
37009,2017,12664,12149,515,4.1
37011,2017,7639,7315,324,4.2
37013,2017,19992,18992,1000,5
37015,2017,8080,7607,473,5.9
37017,2017,14422,13589,833,5.8
37019,2017,51337,48457,2880,5.6
37021,2017,136616,131958,4658,3.4
37023,2017,40502,38822,1680,4.1
37025,2017,104706,100409,4297,4.1
37027,2017,36518,34907,1611,4.4
37029,2017,4728,4524,204,4.3
37031,2017,31934,30530,1404,4.4
37033,2017,9769,9312,457,4.7
37035,2017,78657,75428,3229,4.1
37037,2017,34170,32858,1312,3.8
37039,2017,11175,10624,551,4.9
37041,2017,5599,5306,293,5.2
37043,2017,3952,3757,195,4.9
37045,2017,47491,45316,2175,4.6
37047,2017,22289,21083,1206,5.4
37049,2017,41759,39840,1919,4.6
37051,2017,127703,120440,7263,5.7
37053,2017,13582,12997,585,4.3
37055,2017,20112,18936,1176,5.8
37057,2017,79639,76250,3389,4.3
37059,2017,20348,19545,803,3.9
37061,2017,25456,24231,1225,4.8
37063,2017,165274,158652,6622,4
37065,2017,21939,20266,1673,7.6
37067,2017,184810,176817,7993,4.3
37069,2017,30111,28720,1391,4.6
37071,2017,107808,102873,4935,4.6
37073,2017,5280,5049,231,4.4
37075,2017,3129,2917,212,6.8
37077,2017,30027,28893,1134,3.8
37079,2017,9551,9132,419,4.4
37081,2017,260811,248524,12287,4.7
37083,2017,20564,19081,1483,7.2
37085,2017,52576,49918,2658,5.1
37087,2017,28952,27799,1153,4
37089,2017,53508,51491,2017,3.8
37091,2017,9186,8663,523,5.7
37093,2017,19916,18779,1137,5.7
37095,2017,2099,1924,175,8.300000000000001
37097,2017,86508,82869,3639,4.2
37099,2017,19067,18165,902,4.7
37101,2017,94409,90532,3877,4.1
37103,2017,4408,4215,193,4.4
37105,2017,26576,25230,1346,5.1
37107,2017,28015,26780,1235,4.4
37109,2017,41918,40245,1673,4
37111,2017,20976,20134,842,4
37113,2017,15230,14531,699,4.6
37115,2017,9969,9549,420,4.2
37117,2017,9589,9056,533,5.6
37119,2017,600609,575010,25599,4.3
37121,2017,6097,5783,314,5.2
37123,2017,11752,11223,529,4.5
37125,2017,39874,38107,1767,4.4
37127,2017,43662,41059,2603,6
37129,2017,119415,114537,4878,4.1
37131,2017,7743,7265,478,6.2
37133,2017,64554,61201,3353,5.2
37135,2017,76671,73804,2867,3.7
37137,2017,5388,5142,246,4.6
37139,2017,17355,16404,951,5.5
37141,2017,27971,26691,1280,4.6
37143,2017,5138,4851,287,5.6
37145,2017,18027,17194,833,4.6
37147,2017,89301,84997,4304,4.8
37149,2017,8918,8551,367,4.1
37151,2017,66629,63744,2885,4.3
37153,2017,16711,15716,995,6
37155,2017,50181,46945,3236,6.4
37157,2017,40564,38481,2083,5.1
37159,2017,64752,61737,3015,4.7
37161,2017,24589,23112,1477,6
37163,2017,29405,28020,1385,4.7
37165,2017,11500,10626,874,7.6
37167,2017,29771,28556,1215,4.1
37169,2017,21640,20732,908,4.2
37171,2017,33611,32222,1389,4.1
37173,2017,6844,6501,343,5
37175,2017,14217,13610,607,4.3
37177,2017,1495,1381,114,7.6
37179,2017,119127,114401,4726,4
37181,2017,17890,16790,1100,6.1
37183,2017,573417,551245,22172,3.9
37185,2017,6824,6362,462,6.8
37187,2017,4770,4458,312,6.5
37189,2017,28571,27422,1149,4
37191,2017,53403,50743,2660,5
37193,2017,30918,29615,1303,4.2
37195,2017,35958,33386,2572,7.2
37197,2017,17696,17006,690,3.9
37199,2017,7427,7091,336,4.5
38001,2017,1113,1085,28,2.5
38003,2017,5410,5258,152,2.8
38005,2017,2385,2298,87,3.6
38007,2017,439,425,14,3.2
38009,2017,3104,3000,104,3.4
38011,2017,1751,1720,31,1.8
38013,2017,1089,1055,34,3.1
38015,2017,50370,49125,1245,2.5
38017,2017,101672,99495,2177,2.1
38019,2017,2052,1997,55,2.7
38021,2017,2502,2458,44,1.8
38023,2017,1580,1554,26,1.6
38025,2017,3157,3089,68,2.2
38027,2017,1268,1208,60,4.7
38029,2017,1546,1484,62,4
38031,2017,1653,1612,41,2.5
38033,2017,931,912,19,2
38035,2017,38883,38015,868,2.2
38037,2017,1276,1238,38,3
38039,2017,1121,1088,33,2.9
38041,2017,1471,1443,28,1.9
38043,2017,1360,1311,49,3.6
38045,2017,2263,2220,43,1.9
38047,2017,943,919,24,2.5
38049,2017,3285,3143,142,4.3
38051,2017,1222,1190,32,2.6
38053,2017,8136,7931,205,2.5
38055,2017,5000,4840,160,3.2
38057,2017,4434,4254,180,4.1
38059,2017,16594,16076,518,3.1
38061,2017,6991,6846,145,2.1
38063,2017,1485,1439,46,3.1
38065,2017,910,872,38,4.2
38067,2017,3511,3363,148,4.2
38069,2017,1877,1817,60,3.2
38071,2017,5849,5690,159,2.7
38073,2017,2808,2753,55,2
38075,2017,1267,1234,33,2.6
38077,2017,8791,8579,212,2.4
38079,2017,4818,4314,504,10.5
38081,2017,2377,2328,49,2.1
38083,2017,731,698,33,4.5
38085,2017,1290,1241,49,3.8
38087,2017,426,417,9,2.1
38089,2017,17944,17453,491,2.7
38091,2017,1054,1036,18,1.7
38093,2017,10930,10670,260,2.4
38095,2017,1242,1210,32,2.6
38097,2017,4577,4464,113,2.5
38099,2017,5570,5381,189,3.4
38101,2017,32466,31396,1070,3.3
38103,2017,2137,2067,70,3.3
38105,2017,22689,22112,577,2.5
39001,2017,10891,10106,785,7.2
39003,2017,48564,46130,2434,5
39005,2017,26220,24924,1296,4.9
39007,2017,44120,41506,2614,5.9
39009,2017,28319,26596,1723,6.1
39011,2017,24673,23757,916,3.7
39013,2017,30336,28407,1929,6.4
39015,2017,19483,18363,1120,5.7
39017,2017,192286,183718,8568,4.5
39019,2017,13239,12461,778,5.9
39021,2017,19895,19071,824,4.1
39023,2017,63629,60528,3101,4.9
39025,2017,105184,100545,4639,4.4
39027,2017,17412,16454,958,5.5
39029,2017,47647,44797,2850,6
39031,2017,14668,13665,1003,6.8
39033,2017,18804,17719,1085,5.8
39035,2017,617638,583182,34456,5.6
39037,2017,26270,25162,1108,4.2
39039,2017,18385,17489,896,4.9
39041,2017,107047,103221,3826,3.6
39043,2017,38106,35764,2342,6.1
39045,2017,77039,73727,3312,4.3
39047,2017,14372,13761,611,4.3
39049,2017,682117,654273,27844,4.1
39051,2017,22446,21340,1106,4.9
39053,2017,12272,11457,815,6.6
39055,2017,49327,47081,2246,4.6
39057,2017,82408,78882,3526,4.3
39059,2017,18930,17786,1144,6
39061,2017,410169,392106,18063,4.4
39063,2017,41560,40050,1510,3.6
39065,2017,14337,13625,712,5
39067,2017,7127,6700,427,6
39069,2017,13509,12807,702,5.2
39071,2017,17124,16101,1023,6
39073,2017,13064,12352,712,5.5
39075,2017,20778,20039,739,3.6
39077,2017,28129,26320,1809,6.4
39079,2017,12881,11959,922,7.2
39081,2017,27799,25748,2051,7.4
39083,2017,31287,29874,1413,4.5
39085,2017,126504,120301,6203,4.9
39087,2017,24015,22582,1433,6
39089,2017,88767,84997,3770,4.2
39091,2017,23502,22539,963,4.1
39093,2017,154163,145104,9059,5.9
39095,2017,210232,197796,12436,5.9
39097,2017,20583,19779,804,3.9
39099,2017,105080,97823,7257,6.9
39101,2017,28052,26630,1422,5.1
39103,2017,97412,93026,4386,4.5
39105,2017,8960,8227,733,8.199999999999999
39107,2017,23480,22757,723,3.1
39109,2017,53449,51170,2279,4.3
39111,2017,5154,4720,434,8.4
39113,2017,251542,239204,12338,4.9
39115,2017,6692,6238,454,6.8
39117,2017,16724,15893,831,5
39119,2017,39756,37495,2261,5.7
39121,2017,4763,4419,344,7.2
39123,2017,21190,19763,1427,6.7
39125,2017,8879,8485,394,4.4
39127,2017,15881,14917,964,6.1
39129,2017,26266,25038,1228,4.7
39131,2017,10850,10091,759,7
39133,2017,87395,82978,4417,5.1
39135,2017,21169,20221,948,4.5
39137,2017,18868,18196,672,3.6
39139,2017,53171,50259,2912,5.5
39141,2017,34187,32430,1757,5.1
39143,2017,31296,29809,1487,4.8
39145,2017,29580,27483,2097,7.1
39147,2017,27367,26067,1300,4.8
39149,2017,24008,23011,997,4.2
39151,2017,187039,177263,9776,5.2
39153,2017,273123,259223,13900,5.1
39155,2017,89065,82628,6437,7.2
39157,2017,45364,43080,2284,5
39159,2017,28360,27296,1064,3.8
39161,2017,14489,13919,570,3.9
39163,2017,5456,5080,376,6.9
39165,2017,116304,111495,4809,4.1
39167,2017,27280,25569,1711,6.3
39169,2017,61613,59198,2415,3.9
39171,2017,18984,18150,834,4.4
39173,2017,70593,67475,3118,4.4
39175,2017,12637,12168,469,3.7
40001,2017,8239,7833,406,4.9
40003,2017,2960,2882,78,2.6
40005,2017,5195,4922,273,5.3
40007,2017,3039,2961,78,2.6
40009,2017,11310,10876,434,3.8
40011,2017,4626,4498,128,2.8
40013,2017,20412,19633,779,3.8
40015,2017,12391,11849,542,4.4
40017,2017,71166,68680,2486,3.5
40019,2017,22491,21479,1012,4.5
40021,2017,19192,18165,1027,5.4
40023,2017,5730,5381,349,6.1
40025,2017,1419,1386,33,2.3
40027,2017,139944,135066,4878,3.5
40029,2017,2276,2155,121,5.3
40031,2017,48989,46848,2141,4.4
40033,2017,2802,2690,112,4
40035,2017,6101,5837,264,4.3
40037,2017,31539,29977,1562,5
40039,2017,15438,14943,495,3.2
40041,2017,18600,17790,810,4.4
40043,2017,2526,2454,72,2.9
40045,2017,2227,2157,70,3.1
40047,2017,27841,26774,1067,3.8
40049,2017,12649,12126,523,4.1
40051,2017,26099,25051,1048,4
40053,2017,2892,2818,74,2.6
40055,2017,2062,1955,107,5.2
40057,2017,1274,1226,48,3.8
40059,2017,1877,1820,57,3
40061,2017,4372,4086,286,6.5
40063,2017,5413,5114,299,5.5
40065,2017,10858,10451,407,3.7
40067,2017,2498,2361,137,5.5
40069,2017,5046,4847,199,3.9
40071,2017,19240,18208,1032,5.4
40073,2017,8723,8483,240,2.8
40075,2017,3933,3727,206,5.2
40077,2017,3398,3146,252,7.4
40079,2017,19373,18261,1112,5.7
40081,2017,15794,15111,683,4.3
40083,2017,21694,20901,793,3.7
40085,2017,6590,6396,194,2.9
40087,2017,19252,18578,674,3.5
40089,2017,14773,13851,922,6.2
40091,2017,6951,6420,531,7.6
40093,2017,4024,3898,126,3.1
40095,2017,6582,6277,305,4.6
40097,2017,19263,18357,906,4.7
40099,2017,6407,6171,236,3.7
40101,2017,29587,28092,1495,5.1
40103,2017,5765,5577,188,3.3
40105,2017,4620,4372,248,5.4
40107,2017,4466,4199,267,6
40109,2017,378349,363326,15023,4
40111,2017,15957,14960,997,6.2
40113,2017,20786,19720,1066,5.1
40115,2017,14503,13878,625,4.3
40117,2017,7411,7019,392,5.3
40119,2017,38933,37556,1377,3.5
40121,2017,17785,16856,929,5.2
40123,2017,18607,17912,695,3.7
40125,2017,33072,31718,1354,4.1
40127,2017,4738,4447,291,6.1
40129,2017,1885,1824,61,3.2
40131,2017,44666,42713,1953,4.4
40133,2017,9458,8924,534,5.6
40135,2017,16602,15701,901,5.4
40137,2017,18219,17102,1117,6.1
40139,2017,9378,9088,290,3.1
40141,2017,3273,3136,137,4.2
40143,2017,320058,306501,13557,4.2
40145,2017,37101,35489,1612,4.3
40147,2017,23262,22221,1041,4.5
40149,2017,5377,5142,235,4.4
40151,2017,4929,4802,127,2.6
40153,2017,9453,9065,388,4.1
41001,2017,7007,6624,383,5.5
41003,2017,48283,46719,1564,3.2
41005,2017,217437,209351,8086,3.7
41007,2017,19218,18429,789,4.1
41009,2017,24250,23006,1244,5.1
41011,2017,26459,25007,1452,5.5
41013,2017,9418,8821,597,6.3
41015,2017,8966,8422,544,6.1
41017,2017,93241,89287,3954,4.2
41019,2017,46214,43747,2467,5.3
41021,2017,855,819,36,4.2
41023,2017,3133,2916,217,6.9
41025,2017,3410,3196,214,6.3
41027,2017,14345,13831,514,3.6
41029,2017,103238,98355,4883,4.7
41031,2017,9974,9415,559,5.6
41033,2017,35171,33288,1883,5.4
41035,2017,29548,27801,1747,5.9
41037,2017,3509,3309,200,5.7
41039,2017,181468,173411,8057,4.4
41041,2017,21095,20088,1007,4.8
41043,2017,57804,55063,2741,4.7
41045,2017,12544,11963,581,4.6
41047,2017,160106,153168,6938,4.3
41049,2017,5754,5501,253,4.4
41051,2017,453416,436974,16442,3.6
41053,2017,39312,37609,1703,4.3
41055,2017,898,856,42,4.7
41057,2017,11748,11249,499,4.2
41059,2017,36702,34932,1770,4.8
41061,2017,11973,11342,631,5.3
41063,2017,3318,3130,188,5.7
41065,2017,13801,13228,573,4.2
41067,2017,320427,309262,11165,3.5
41069,2017,733,704,29,4
41071,2017,54006,51981,2025,3.7
42001,2017,55407,53389,2018,3.6
42003,2017,646086,615683,30403,4.7
42005,2017,32337,30356,1981,6.1
42007,2017,84454,79801,4653,5.5
42009,2017,23761,22540,1221,5.1
42011,2017,212468,202750,9718,4.6
42013,2017,60139,57259,2880,4.8
42015,2017,29301,27806,1495,5.1
42017,2017,340370,326004,14366,4.2
42019,2017,98657,94181,4476,4.5
42021,2017,59648,56073,3575,6
42023,2017,2194,2045,149,6.8
42025,2017,31490,29750,1740,5.5
42027,2017,79092,76192,2900,3.7
42029,2017,281044,271014,10030,3.6
42031,2017,17723,16731,992,5.6
42033,2017,35859,33750,2109,5.9
42035,2017,18350,17233,1117,6.1
42037,2017,33713,31977,1736,5.1
42039,2017,39437,37286,2151,5.5
42041,2017,130224,125303,4921,3.8
42043,2017,142381,136008,6373,4.5
42045,2017,295041,281811,13230,4.5
42047,2017,16015,15246,769,4.8
42049,2017,130712,123236,7476,5.7
42051,2017,57402,53449,3953,6.9
42053,2017,1833,1712,121,6.6
42055,2017,76606,73214,3392,4.4
42057,2017,7249,6883,366,5
42059,2017,16794,15810,984,5.9
42061,2017,19796,18619,1177,5.9
42063,2017,39238,36966,2272,5.8
42065,2017,20567,19429,1138,5.5
42067,2017,12379,11813,566,4.6
42069,2017,105921,100517,5404,5.1
42071,2017,279028,268376,10652,3.8
42073,2017,40631,38186,2445,6
42075,2017,70748,67844,2904,4.1
42077,2017,189669,180225,9444,5
42079,2017,158530,149262,9268,5.8
42081,2017,57842,54631,3211,5.6
42083,2017,18164,17063,1101,6.1
42085,2017,50685,47936,2749,5.4
42087,2017,20675,19583,1092,5.3
42089,2017,82215,77428,4787,5.8
42091,2017,448234,431055,17179,3.8
42093,2017,9105,8757,348,3.8
42095,2017,158626,150897,7729,4.9
42097,2017,43661,41205,2456,5.6
42099,2017,24294,23260,1034,4.3
42101,2017,704948,661229,43719,6.2
42103,2017,24752,23294,1458,5.9
42105,2017,7267,6797,470,6.5
42107,2017,66264,62420,3844,5.8
42109,2017,20717,19810,907,4.4
42111,2017,33634,31613,2021,6
42113,2017,2689,2530,159,5.9
42115,2017,20597,19628,969,4.7
42117,2017,19113,17981,1132,5.9
42119,2017,19675,18822,853,4.3
42121,2017,22955,21564,1391,6.1
42123,2017,19301,18289,1012,5.2
42125,2017,106359,100831,5528,5.2
42127,2017,22413,21276,1137,5.1
42129,2017,180797,171495,9302,5.1
42131,2017,13846,13119,727,5.3
42133,2017,234928,224744,10184,4.3
44001,2017,25955,24970,985,3.8
44003,2017,90048,86403,3645,4
44005,2017,44424,42713,1711,3.9
44007,2017,323972,308660,15312,4.7
44009,2017,68725,66001,2724,4
45001,2017,9973,9514,459,4.6
45003,2017,74086,71044,3042,4.1
45005,2017,2706,2519,187,6.9
45007,2017,89513,85993,3520,3.9
45009,2017,5145,4760,385,7.5
45011,2017,8019,7535,484,6
45013,2017,74382,71349,3033,4.1
45015,2017,99953,96123,3830,3.8
45017,2017,6745,6393,352,5.2
45019,2017,203901,196750,7151,3.5
45021,2017,23843,22659,1184,5
45023,2017,13320,12505,815,6.1
45025,2017,21511,20579,932,4.3
45027,2017,12392,11652,740,6
45029,2017,16618,15820,798,4.8
45031,2017,29926,28348,1578,5.3
45033,2017,12464,11751,713,5.7
45035,2017,74246,71377,2869,3.9
45037,2017,10592,10108,484,4.6
45039,2017,9933,9201,732,7.4
45041,2017,65462,62493,2969,4.5
45043,2017,24905,23512,1393,5.6
45045,2017,248650,239569,9081,3.7
45047,2017,30761,29369,1392,4.5
45049,2017,8120,7759,361,4.4
45051,2017,143776,136558,7218,5
45053,2017,12032,11587,445,3.7
45055,2017,29275,27958,1317,4.5
45057,2017,39423,37583,1840,4.7
45059,2017,29876,28564,1312,4.4
45061,2017,6403,6020,383,6
45063,2017,148762,143404,5358,3.6
45065,2017,3372,3219,153,4.5
45067,2017,12473,11552,921,7.4
45069,2017,9155,8555,600,6.6
45071,2017,18421,17649,772,4.2
45073,2017,34113,32618,1495,4.4
45075,2017,34657,32170,2487,7.2
45077,2017,56283,53956,2327,4.1
45079,2017,199166,190672,8494,4.3
45081,2017,8883,8534,349,3.9
45083,2017,146695,140787,5908,4
45085,2017,44030,41734,2296,5.2
45087,2017,11533,10909,624,5.4
45089,2017,12159,11385,774,6.4
45091,2017,134117,128751,5366,4
46003,2017,1523,1481,42,2.8
46005,2017,9391,9132,259,2.8
46007,2017,1114,1066,48,4.3
46009,2017,2915,2832,83,2.8
46011,2017,18826,18252,574,3
46013,2017,20948,20340,608,2.9
46015,2017,2481,2408,73,2.9
46017,2017,708,657,51,7.2
46019,2017,5026,4853,173,3.4
46021,2017,833,805,28,3.4
46023,2017,3887,3749,138,3.6
46025,2017,1885,1801,84,4.5
46027,2017,7127,6900,227,3.2
46029,2017,15223,14729,494,3.2
46031,2017,1423,1365,58,4.1
46033,2017,4036,3868,168,4.2
46035,2017,11033,10722,311,2.8
46037,2017,2827,2716,111,3.9
46039,2017,2197,2093,104,4.7
46041,2017,2248,2027,221,9.800000000000001
46043,2017,1596,1550,46,2.9
46045,2017,2115,2057,58,2.7
46047,2017,2981,2864,117,3.9
46049,2017,1101,1068,33,3
46051,2017,4455,4303,152,3.4
46053,2017,2054,1984,70,3.4
46055,2017,1103,1073,30,2.7
46057,2017,3151,3040,111,3.5
46059,2017,1824,1781,43,2.4
46061,2017,1772,1702,70,4
46063,2017,727,706,21,2.9
46065,2017,10021,9753,268,2.7
46067,2017,3611,3504,107,3
46069,2017,685,664,21,3.1
46071,2017,1324,1251,73,5.5
46073,2017,1140,1113,27,2.4
46075,2017,561,545,16,2.9
46077,2017,2678,2596,82,3.1
46079,2017,6505,6262,243,3.7
46081,2017,13052,12636,416,3.2
46083,2017,32965,32172,793,2.4
46085,2017,1747,1662,85,4.9
46087,2017,3060,2977,83,2.7
46089,2017,1050,1015,35,3.3
46091,2017,2400,2295,105,4.4
46093,2017,13965,13501,464,3.3
46095,2017,764,728,36,4.7
46097,2017,1195,1161,34,2.8
46099,2017,109321,106305,3016,2.8
46101,2017,3984,3841,143,3.6
46102,2017,3624,3216,408,11.3
46103,2017,55732,53902,1830,3.3
46105,2017,1592,1548,44,2.8
46107,2017,1123,1086,37,3.3
46109,2017,4822,4597,225,4.7
46111,2017,1176,1135,41,3.5
46115,2017,3232,3125,107,3.3
46117,2017,1866,1806,60,3.2
46119,2017,835,809,26,3.1
46121,2017,3138,2935,203,6.5
46123,2017,3038,2954,84,2.8
46125,2017,4674,4527,147,3.1
46127,2017,8045,7761,284,3.5
46129,2017,2237,2127,110,4.9
46135,2017,11611,11282,329,2.8
46137,2017,939,890,49,5.2
47001,2017,33790,32451,1339,4
47003,2017,20479,19665,814,4
47005,2017,6703,6338,365,5.4
47007,2017,4286,4032,254,5.9
47009,2017,61461,59282,2179,3.5
47011,2017,50727,48868,1859,3.7
47013,2017,14581,13817,764,5.2
47015,2017,6183,5962,221,3.6
47017,2017,11904,11287,617,5.2
47019,2017,23814,22723,1091,4.6
47021,2017,20791,20149,642,3.1
47023,2017,8312,7979,333,4
47025,2017,12675,12072,603,4.8
47027,2017,3025,2869,156,5.2
47029,2017,14564,13795,769,5.3
47031,2017,24881,23963,918,3.7
47033,2017,6941,6651,290,4.2
47035,2017,23327,22235,1092,4.7
47037,2017,383649,372829,10820,2.8
47039,2017,4658,4414,244,5.2
47041,2017,7643,7273,370,4.8
47043,2017,25459,24599,860,3.4
47045,2017,16048,15264,784,4.9
47047,2017,18538,17790,748,4
47049,2017,7070,6747,323,4.6
47051,2017,19785,19030,755,3.8
47053,2017,21219,20240,979,4.6
47055,2017,15499,14966,533,3.4
47057,2017,9295,8897,398,4.3
47059,2017,30267,28873,1394,4.6
47061,2017,4816,4573,243,5
47063,2017,27222,26111,1111,4.1
47065,2017,176088,169603,6485,3.7
47067,2017,2039,1920,119,5.8
47069,2017,9189,8707,482,5.2
47071,2017,10368,9874,494,4.8
47073,2017,23603,22588,1015,4.3
47075,2017,7776,7367,409,5.3
47077,2017,11858,11243,615,5.2
47079,2017,13937,13299,638,4.6
47081,2017,10809,10434,375,3.5
47083,2017,3193,3005,188,5.9
47085,2017,8767,8384,383,4.4
47087,2017,4584,4337,247,5.4
47089,2017,23835,22863,972,4.1
47091,2017,7573,7274,299,3.9
47093,2017,236767,229187,7580,3.2
47095,2017,1835,1732,103,5.6
47097,2017,9376,8830,546,5.8
47099,2017,17737,16951,786,4.4
47101,2017,4932,4705,227,4.6
47103,2017,16243,15708,535,3.3
47105,2017,22580,21741,839,3.7
47107,2017,22606,21608,998,4.4
47109,2017,8519,8035,484,5.7
47111,2017,10680,10310,370,3.5
47113,2017,47954,46050,1904,4
47115,2017,12009,11420,589,4.9
47117,2017,15051,14520,531,3.5
47119,2017,45890,44388,1502,3.3
47121,2017,4985,4722,263,5.3
47123,2017,19596,18802,794,4.1
47125,2017,81765,78386,3379,4.1
47127,2017,3471,3361,110,3.2
47129,2017,7780,7397,383,4.9
47131,2017,12185,11510,675,5.5
47133,2017,9500,9104,396,4.2
47135,2017,3229,3072,157,4.9
47137,2017,2442,2333,109,4.5
47139,2017,7372,7033,339,4.6
47141,2017,33897,32595,1302,3.8
47143,2017,13198,12335,863,6.5
47145,2017,22869,21852,1017,4.4
47147,2017,35874,34637,1237,3.4
47149,2017,171109,166081,5028,2.9
47151,2017,8146,7728,418,5.1
47153,2017,5947,5644,303,5.1
47155,2017,52007,49906,2101,4
47157,2017,436135,417021,19114,4.4
47159,2017,8892,8570,322,3.6
47161,2017,5171,4891,280,5.4
47163,2017,69799,66959,2840,4.1
47165,2017,95538,92656,2882,3
47167,2017,27526,26297,1229,4.5
47169,2017,4736,4571,165,3.5
47171,2017,7033,6652,381,5.4
47173,2017,7359,7033,326,4.4
47175,2017,2083,1994,89,4.3
47177,2017,17111,16429,682,4
47179,2017,59352,57093,2259,3.8
47181,2017,6108,5784,324,5.3
47183,2017,15725,14954,771,4.9
47185,2017,11872,11395,477,4
47187,2017,119252,116005,3247,2.7
47189,2017,70776,68655,2121,3
48001,2017,23259,22413,846,3.6
48003,2017,9002,8724,278,3.1
48005,2017,36648,34786,1862,5.1
48007,2017,10332,9628,704,6.8
48009,2017,4142,4003,139,3.4
48011,2017,918,894,24,2.6
48013,2017,20943,20052,891,4.3
48015,2017,13805,13197,608,4.4
48017,2017,2661,2547,114,4.3
48019,2017,9741,9389,352,3.6
48021,2017,40197,38756,1441,3.6
48023,2017,1589,1535,54,3.4
48025,2017,9970,9325,645,6.5
48027,2017,142118,136070,6048,4.3
48029,2017,924257,891563,32694,3.5
48031,2017,6228,6057,171,2.7
48033,2017,322,311,11,3.4
48035,2017,8197,7870,327,4
48037,2017,39276,37479,1797,4.6
48039,2017,173279,164089,9190,5.3
48041,2017,113040,109558,3482,3.1
48043,2017,3968,3829,139,3.5
48045,2017,554,530,24,4.3
48047,2017,2433,2232,201,8.300000000000001
48049,2017,16091,15468,623,3.9
48051,2017,7992,7657,335,4.2
48053,2017,22274,21567,707,3.2
48055,2017,18510,17785,725,3.9
48057,2017,10497,9891,606,5.8
48059,2017,5912,5697,215,3.6
48061,2017,166244,154709,11535,6.9
48063,2017,5027,4743,284,5.6
48065,2017,3030,2932,98,3.2
48067,2017,12192,11467,725,5.9
48069,2017,3394,3282,112,3.3
48071,2017,18922,17693,1229,6.5
48073,2017,20779,19837,942,4.5
48075,2017,2910,2824,86,3
48077,2017,4903,4731,172,3.5
48079,2017,1133,1081,52,4.6
48081,2017,1400,1348,52,3.7
48083,2017,3068,2931,137,4.5
48085,2017,532152,513771,18381,3.5
48087,2017,1166,1125,41,3.5
48089,2017,9748,9359,389,4
48091,2017,68795,66483,2312,3.4
48093,2017,5304,5109,195,3.7
48095,2017,1213,1162,51,4.2
48097,2017,18854,18175,679,3.6
48099,2017,24400,23332,1068,4.4
48101,2017,520,498,22,4.2
48103,2017,1594,1510,84,5.3
48105,2017,1679,1611,68,4.1
48107,2017,2547,2440,107,4.2
48109,2017,923,889,34,3.7
48111,2017,4060,3973,87,2.1
48113,2017,1326972,1274970,52002,3.9
48115,2017,4631,4407,224,4.8
48117,2017,8349,8095,254,3
48119,2017,2548,2462,86,3.4
48121,2017,471180,455462,15718,3.3
48123,2017,9582,9163,419,4.4
48125,2017,680,647,33,4.9
48127,2017,6489,6161,328,5.1
48129,2017,1503,1449,54,3.6
48131,2017,4801,4433,368,7.7
48133,2017,7941,7602,339,4.3
48135,2017,78564,75345,3219,4.1
48137,2017,906,877,29,3.2
48139,2017,87802,84756,3046,3.5
48141,2017,354160,337807,16353,4.6
48143,2017,20687,19981,706,3.4
48145,2017,6648,6367,281,4.2
48147,2017,15952,15420,532,3.3
48149,2017,12577,12176,401,3.2
48151,2017,1704,1643,61,3.6
48153,2017,2701,2554,147,5.4
48155,2017,595,574,21,3.5
48157,2017,375627,358184,17443,4.6
48159,2017,4544,4333,211,4.6
48161,2017,6755,6325,430,6.4
48163,2017,9364,8996,368,3.9
48165,2017,9248,8968,280,3
48167,2017,161977,153462,8515,5.3
48169,2017,2121,2051,70,3.3
48171,2017,13136,12795,341,2.6
48173,2017,709,690,19,2.7
48175,2017,3276,3115,161,4.9
48177,2017,9372,9046,326,3.5
48179,2017,8234,7802,432,5.2
48181,2017,61945,59749,2196,3.5
48183,2017,57403,54442,2961,5.2
48185,2017,10884,10302,582,5.3
48187,2017,78444,75830,2614,3.3
48189,2017,12514,11874,640,5.1
48191,2017,1129,1060,69,6.1
48193,2017,3621,3479,142,3.9
48195,2017,2862,2789,73,2.6
48197,2017,1659,1593,66,4
48199,2017,25303,23752,1551,6.1
48201,2017,2265691,2150927,114764,5.1
48203,2017,29464,27926,1538,5.2
48205,2017,2940,2883,57,1.9
48207,2017,2438,2321,117,4.8
48209,2017,110721,107235,3486,3.1
48211,2017,2315,2257,58,2.5
48213,2017,35640,34153,1487,4.2
48215,2017,342969,317398,25571,7.5
48217,2017,16170,15534,636,3.9
48219,2017,11262,10844,418,3.7
48221,2017,25925,24835,1090,4.2
48223,2017,17169,16552,617,3.6
48225,2017,10387,9937,450,4.3
48227,2017,13220,12657,563,4.3
48229,2017,1664,1568,96,5.8
48231,2017,41383,39733,1650,4
48233,2017,9400,8832,568,6
48235,2017,756,733,23,3
48237,2017,3953,3806,147,3.7
48239,2017,7374,7080,294,4
48241,2017,13448,12446,1002,7.5
48243,2017,1067,1033,34,3.2
48245,2017,107606,99675,7931,7.4
48247,2017,1906,1767,139,7.3
48249,2017,16653,15391,1262,7.6
48251,2017,78088,75128,2960,3.8
48253,2017,5650,5349,301,5.3
48255,2017,6448,6223,225,3.5
48257,2017,60334,58196,2138,3.5
48259,2017,21094,20446,648,3.1
48261,2017,242,234,8,3.3
48263,2017,454,442,12,2.6
48265,2017,21336,20609,727,3.4
48267,2017,1891,1824,67,3.5
48269,2017,165,159,6,3.6
48271,2017,1166,1101,65,5.6
48273,2017,13396,12604,792,5.9
48275,2017,1484,1425,59,4
48277,2017,23756,22760,996,4.2
48279,2017,5191,4923,268,5.2
48281,2017,9213,8869,344,3.7
48283,2017,4206,4052,154,3.7
48285,2017,8735,8420,315,3.6
48287,2017,9540,9225,315,3.3
48289,2017,6188,5797,391,6.3
48291,2017,31979,29702,2277,7.1
48293,2017,8316,7853,463,5.6
48295,2017,1625,1573,52,3.2
48297,2017,5418,5165,253,4.7
48299,2017,8366,8048,318,3.8
48301,2017,100,95,5,5
48303,2017,155992,151032,4960,3.2
48305,2017,2773,2669,104,3.8
48307,2017,3685,3555,130,3.5
48309,2017,118071,113493,4578,3.9
48311,2017,749,735,14,1.9
48313,2017,4686,4465,221,4.7
48315,2017,4336,4090,246,5.7
48317,2017,2525,2444,81,3.2
48319,2017,1814,1753,61,3.4
48321,2017,16903,15671,1232,7.3
48323,2017,23924,21690,2234,9.300000000000001
48325,2017,21282,20457,825,3.9
48327,2017,806,767,39,4.8
48329,2017,90759,88048,2711,3
48331,2017,10094,9586,508,5
48333,2017,1912,1844,68,3.6
48335,2017,2498,2362,136,5.4
48337,2017,9088,8725,363,4
48339,2017,270212,258443,11769,4.4
48341,2017,11070,10752,318,2.9
48343,2017,4678,4276,402,8.6
48345,2017,495,477,18,3.6
48347,2017,28559,27346,1213,4.2
48349,2017,22820,21921,899,3.9
48351,2017,5277,4856,421,8
48353,2017,6779,6506,273,4
48355,2017,167983,158897,9086,5.4
48357,2017,4523,4359,164,3.6
48359,2017,902,879,23,2.5
48361,2017,37146,34577,2569,6.9
48363,2017,13401,12852,549,4.1
48365,2017,10407,9843,564,5.4
48367,2017,63232,61045,2187,3.5
48369,2017,4920,4799,121,2.5
48371,2017,6270,5978,292,4.7
48373,2017,17526,16459,1067,6.1
48375,2017,55437,53656,1781,3.2
48377,2017,3041,2755,286,9.4
48379,2017,5702,5497,205,3.6
48381,2017,70916,68918,1998,2.8
48383,2017,1794,1725,69,3.8
48385,2017,1054,994,60,5.7
48387,2017,5199,4927,272,5.2
48389,2017,6995,6745,250,3.6
48391,2017,3242,3061,181,5.6
48393,2017,441,424,17,3.9
48395,2017,7448,7096,352,4.7
48397,2017,48975,47330,1645,3.4
48399,2017,4580,4411,169,3.7
48401,2017,22125,21002,1123,5.1
48403,2017,3574,3267,307,8.6
48405,2017,2869,2654,215,7.5
48407,2017,11460,10807,653,5.7
48409,2017,30563,28218,2345,7.7
48411,2017,2418,2340,78,3.2
48413,2017,1334,1284,50,3.7
48415,2017,6987,6685,302,4.3
48417,2017,1889,1833,56,3
48419,2017,10779,10223,556,5.2
48421,2017,1290,1250,40,3.1
48423,2017,106035,101697,4338,4.1
48425,2017,4188,3997,191,4.6
48427,2017,26103,23034,3069,11.8
48429,2017,4005,3823,182,4.5
48431,2017,594,572,22,3.7
48433,2017,614,593,21,3.4
48435,2017,1507,1430,77,5.1
48437,2017,2691,2581,110,4.1
48439,2017,1036343,997799,38544,3.7
48441,2017,64214,61947,2267,3.5
48443,2017,393,375,18,4.6
48445,2017,5245,4981,264,5
48447,2017,691,661,30,4.3
48449,2017,12950,12252,698,5.4
48451,2017,54164,52178,1986,3.7
48453,2017,698699,677404,21295,3
48455,2017,5376,5079,297,5.5
48457,2017,7072,6553,519,7.3
48459,2017,17719,16791,928,5.2
48461,2017,1548,1490,58,3.7
48463,2017,11703,11156,547,4.7
48465,2017,20092,19071,1021,5.1
48467,2017,25386,24433,953,3.8
48469,2017,42948,40874,2074,4.8
48471,2017,23686,22591,1095,4.6
48473,2017,22384,21289,1095,4.9
48475,2017,5587,5361,226,4
48477,2017,14872,14246,626,4.2
48479,2017,115116,110273,4843,4.2
48481,2017,21099,20153,946,4.5
48483,2017,2353,2260,93,4
48485,2017,56078,54010,2068,3.7
48487,2017,4962,4730,232,4.7
48489,2017,6323,5626,697,11
48491,2017,290795,281296,9499,3.3
48493,2017,24184,23340,844,3.5
48495,2017,3259,3092,167,5.1
48497,2017,30173,28965,1208,4
48499,2017,17343,16529,814,4.7
48501,2017,3823,3688,135,3.5
48503,2017,8076,7772,304,3.8
48505,2017,5389,4988,401,7.4
48507,2017,3732,3315,417,11.2
49001,2017,3040,2916,124,4.1
49003,2017,25317,24486,831,3.3
49005,2017,62596,60855,1741,2.8
49007,2017,8278,7858,420,5.1
49009,2017,429,408,21,4.9
49011,2017,168545,163348,5197,3.1
49013,2017,7977,7519,458,5.7
49015,2017,4189,3973,216,5.2
49017,2017,2900,2681,219,7.6
49019,2017,5932,5616,316,5.3
49021,2017,22241,21309,932,4.2
49023,2017,5420,5237,183,3.4
49025,2017,3743,3614,129,3.4
49027,2017,6431,6220,211,3.3
49029,2017,5387,5233,154,2.9
49031,2017,483,459,24,5
49033,2017,1140,1103,37,3.2
49035,2017,614498,595348,19150,3.1
49037,2017,5696,5295,401,7
49039,2017,12011,11536,475,4
49041,2017,9785,9406,379,3.9
49043,2017,24325,23567,758,3.1
49045,2017,32306,31139,1167,3.6
49047,2017,13680,12850,830,6.1
49049,2017,290640,282093,8547,2.9
49051,2017,14603,14116,487,3.3
49053,2017,70715,68238,2477,3.5
49055,2017,1461,1353,108,7.4
49057,2017,123223,118690,4533,3.7
50001,2017,20770,20197,573,2.8
50003,2017,18266,17616,650,3.6
50005,2017,14698,14165,533,3.6
50007,2017,96775,94635,2140,2.2
50009,2017,2694,2572,122,4.5
50011,2017,27632,26810,822,3
50013,2017,4060,3922,138,3.4
50015,2017,14076,13526,550,3.9
50017,2017,15933,15454,479,3
50019,2017,13601,12920,681,5
50021,2017,31096,30030,1066,3.4
50023,2017,34260,33273,987,2.9
50025,2017,22823,22132,691,3
50027,2017,29048,28318,730,2.5
51001,2017,16628,15876,752,4.5
51003,2017,55339,53519,1820,3.3
51005,2017,7004,6683,321,4.6
51007,2017,6208,5961,247,4
51009,2017,15002,14389,613,4.1
51011,2017,7083,6774,309,4.4
51013,2017,149893,146174,3719,2.5
51015,2017,36715,35468,1247,3.4
51017,2017,2561,2484,77,3
51019,2017,38089,36619,1470,3.9
51021,2017,2868,2750,118,4.1
51023,2017,17267,16661,606,3.5
51025,2017,6118,5794,324,5.3
51027,2017,6989,6496,493,7.1
51029,2017,6316,5977,339,5.4
51031,2017,26051,24974,1077,4.1
51033,2017,15020,14375,645,4.3
51035,2017,13507,12911,596,4.4
51036,2017,3683,3507,176,4.8
51037,2017,5320,5078,242,4.5
51041,2017,183611,177006,6605,3.6
51043,2017,7448,7194,254,3.4
51045,2017,2287,2188,99,4.3
51047,2017,23900,23037,863,3.6
51049,2017,4685,4491,194,4.1
51051,2017,4631,4318,313,6.8
51053,2017,13422,12822,600,4.5
51057,2017,5588,5320,268,4.8
51059,2017,622985,604061,18924,3
51061,2017,35918,34743,1175,3.3
51063,2017,8075,7780,295,3.7
51065,2017,13408,13000,408,3
51067,2017,26307,25282,1025,3.9
51069,2017,46372,44897,1475,3.2
51071,2017,7866,7499,367,4.7
51073,2017,19350,18712,638,3.3
51075,2017,10821,10443,378,3.5
51077,2017,7670,7367,303,4
51079,2017,10142,9834,308,3
51081,2017,4424,4232,192,4.3
51083,2017,15544,14785,759,4.9
51085,2017,58112,56188,1924,3.3
51087,2017,180160,173585,6575,3.6
51089,2017,23750,22650,1100,4.6
51091,2017,1292,1250,42,3.3
51093,2017,19083,18352,731,3.8
51095,2017,35889,34630,1259,3.5
51097,2017,3798,3666,132,3.5
51099,2017,12933,12450,483,3.7
51101,2017,8927,8621,306,3.4
51103,2017,5332,5055,277,5.2
51105,2017,8546,8105,441,5.2
51107,2017,214084,207604,6480,3
51109,2017,19574,18908,666,3.4
51111,2017,5352,5131,221,4.1
51113,2017,7261,7049,212,2.9
51115,2017,4093,3941,152,3.7
51117,2017,12736,12115,621,4.9
51119,2017,5314,5142,172,3.2
51121,2017,49663,47802,1861,3.7
51125,2017,7283,7029,254,3.5
51127,2017,11978,11598,380,3.2
51131,2017,5514,5206,308,5.6
51133,2017,5558,5269,289,5.2
51135,2017,7123,6852,271,3.8
51137,2017,16852,16218,634,3.8
51139,2017,11868,11260,608,5.1
51141,2017,7688,7363,325,4.2
51143,2017,30652,29339,1313,4.3
51145,2017,13729,13275,454,3.3
51147,2017,10237,9744,493,4.8
51149,2017,14919,14255,664,4.5
51153,2017,239266,231140,8126,3.4
51155,2017,16197,15338,859,5.3
51157,2017,3645,3518,127,3.5
51159,2017,4043,3897,146,3.6
51161,2017,48893,47231,1662,3.4
51163,2017,10570,10134,436,4.1
51165,2017,40587,39271,1316,3.2
51167,2017,11433,10839,594,5.2
51169,2017,9302,8926,376,4
51171,2017,21621,20891,730,3.4
51173,2017,13876,13186,690,5
51175,2017,9032,8708,324,3.6
51177,2017,65375,62938,2437,3.7
51179,2017,69424,66922,2502,3.6
51181,2017,3738,3573,165,4.4
51183,2017,3819,3592,227,5.9
51185,2017,16148,15239,909,5.6
51187,2017,19859,19124,735,3.7
51191,2017,26823,25723,1100,4.1
51193,2017,9353,8937,416,4.4
51195,2017,13538,12678,860,6.4
51197,2017,14026,13324,702,5
51199,2017,32501,31362,1139,3.5
51510,2017,99307,96481,2826,2.8
51520,2017,7343,7013,330,4.5
51530,2017,3354,3213,141,4.2
51540,2017,25767,24974,793,3.1
51550,2017,120860,116298,4562,3.8
51570,2017,8746,8393,353,4
51580,2017,2446,2299,147,6
51590,2017,19928,18803,1125,5.6
51595,2017,2361,2237,124,5.3
51600,2017,12956,12584,372,2.9
51610,2017,8326,8107,219,2.6
51620,2017,3569,3381,188,5.3
51630,2017,13591,12998,593,4.4
51640,2017,3005,2880,125,4.2
51650,2017,64427,61183,3244,5
51660,2017,24767,23679,1088,4.4
51670,2017,9740,9144,596,6.1
51678,2017,2122,1994,128,6
51680,2017,36030,34263,1767,4.9
51683,2017,21633,20905,728,3.4
51685,2017,8840,8544,296,3.3
51690,2017,5508,5163,345,6.3
51700,2017,88940,84851,4089,4.6
51710,2017,111593,106473,5120,4.6
51720,2017,1700,1611,89,5.2
51730,2017,13145,12186,959,7.3
51735,2017,6265,6052,213,3.4
51740,2017,44257,41889,2368,5.4
51750,2017,8337,7927,410,4.9
51760,2017,116822,111802,5020,4.3
51770,2017,48956,46927,2029,4.1
51775,2017,13034,12549,485,3.7
51790,2017,11861,11437,424,3.6
51800,2017,43983,42193,1790,4.1
51810,2017,231550,223354,8196,3.5
51820,2017,10418,10003,415,4
51830,2017,6739,6390,349,5.2
51840,2017,14469,13943,526,3.6
53001,2017,8885,8369,516,5.8
53003,2017,10233,9799,434,4.2
53005,2017,96881,91463,5418,5.6
53007,2017,44246,42072,2174,4.9
53009,2017,27749,25834,1915,6.9
53011,2017,227605,215883,11722,5.2
53013,2017,1773,1672,101,5.7
53015,2017,45695,42881,2814,6.2
53017,2017,21094,19882,1212,5.7
53019,2017,2514,2233,281,11.2
53021,2017,40682,38067,2615,6.4
53023,2017,904,855,49,5.4
53025,2017,45099,42238,2861,6.3
53027,2017,27827,25833,1994,7.2
53029,2017,33917,32133,1784,5.3
53031,2017,11907,11170,737,6.2
53033,2017,1238090,1194955,43135,3.5
53035,2017,120251,114308,5943,4.9
53037,2017,22242,21043,1199,5.4
53039,2017,9881,9285,596,6
53041,2017,33087,30869,2218,6.7
53043,2017,4945,4697,248,5
53045,2017,23775,22189,1586,6.7
53047,2017,20919,19475,1444,6.9
53049,2017,8335,7738,597,7.2
53051,2017,4729,4374,355,7.5
53053,2017,415689,393077,22612,5.4
53055,2017,8184,7855,329,4
53057,2017,59305,56012,3293,5.6
53059,2017,5286,4959,327,6.2
53061,2017,423819,407363,16456,3.9
53063,2017,239480,226384,13096,5.5
53065,2017,18083,16750,1333,7.4
53067,2017,134189,127424,6765,5
53069,2017,1305,1209,96,7.4
53071,2017,28831,27383,1448,5
53073,2017,109892,104326,5566,5.1
53075,2017,23290,22255,1035,4.4
53077,2017,125504,116825,8679,6.9
54001,2017,6804,6408,396,5.8
54003,2017,56125,54081,2044,3.6
54005,2017,7544,7061,483,6.4
54007,2017,5244,4851,393,7.5
54009,2017,9763,9170,593,6.1
54011,2017,41466,39584,1882,4.5
54013,2017,2403,2144,259,10.8
54015,2017,3146,2875,271,8.6
54017,2017,3882,3717,165,4.3
54019,2017,15715,14712,1003,6.4
54021,2017,2401,2229,172,7.2
54023,2017,5891,5562,329,5.6
54025,2017,15711,14949,762,4.9
54027,2017,10319,9915,404,3.9
54029,2017,12801,12028,773,6
54031,2017,5897,5609,288,4.9
54033,2017,33125,31532,1593,4.8
54035,2017,11998,11316,682,5.7
54037,2017,29257,28352,905,3.1
54039,2017,82962,78764,4198,5.1
54041,2017,6515,6085,430,6.6
54043,2017,7152,6663,489,6.8
54045,2017,10764,9963,801,7.4
54047,2017,4667,4250,417,8.9
54049,2017,25316,23981,1335,5.3
54051,2017,13955,13126,829,5.9
54053,2017,9987,9317,670,6.7
54055,2017,21296,20056,1240,5.8
54057,2017,12193,11552,641,5.3
54059,2017,6748,6167,581,8.6
54061,2017,52782,50824,1958,3.7
54063,2017,5888,5629,259,4.4
54065,2017,7807,7499,308,3.9
54067,2017,9244,8584,660,7.1
54069,2017,20892,19911,981,4.7
54071,2017,3556,3423,133,3.7
54073,2017,2814,2616,198,7
54075,2017,3741,3520,221,5.9
54077,2017,15194,14445,749,4.9
54079,2017,26201,24973,1228,4.7
54081,2017,29362,27791,1571,5.4
54083,2017,12127,11474,653,5.4
54085,2017,4398,4157,241,5.5
54087,2017,5018,4582,436,8.699999999999999
54089,2017,4374,4116,258,5.9
54091,2017,7797,7416,381,4.9
54093,2017,3398,3222,176,5.2
54095,2017,3211,2965,246,7.7
54097,2017,9397,8821,576,6.1
54099,2017,15566,14663,903,5.8
54101,2017,3294,3086,208,6.3
54103,2017,6730,6223,507,7.5
54105,2017,2195,2022,173,7.9
54107,2017,36094,34118,1976,5.5
54109,2017,6857,6373,484,7.1
55001,2017,8239,7820,419,5.1
55003,2017,7897,7537,360,4.6
55005,2017,24717,23848,869,3.5
55007,2017,7585,7190,395,5.2
55009,2017,142790,138594,4196,2.9
55011,2017,6584,6337,247,3.8
55013,2017,7351,6995,356,4.8
55015,2017,27917,27139,778,2.8
55017,2017,33466,32289,1177,3.5
55019,2017,17977,17427,550,3.1
55021,2017,31733,30795,938,3
55023,2017,7886,7557,329,4.2
55025,2017,320586,312894,7692,2.4
55027,2017,48430,47025,1405,2.9
55029,2017,15578,14979,599,3.8
55031,2017,23559,22510,1049,4.5
55033,2017,24463,23661,802,3.3
55035,2017,59322,57600,1722,2.9
55037,2017,2289,2182,107,4.7
55039,2017,57067,55452,1615,2.8
55041,2017,4028,3825,203,5
55043,2017,28207,27319,888,3.1
55045,2017,21138,20556,582,2.8
55047,2017,9716,9351,365,3.8
55049,2017,13809,13401,408,3
55051,2017,2610,2448,162,6.2
55053,2017,10431,10080,351,3.4
55055,2017,45636,44181,1455,3.2
55057,2017,13597,13143,454,3.3
55059,2017,89439,85988,3451,3.9
55061,2017,11192,10847,345,3.1
55063,2017,67684,65712,1972,2.9
55065,2017,10158,9901,257,2.5
55067,2017,9646,9240,406,4.2
55069,2017,15505,14953,552,3.6
55071,2017,41725,40254,1471,3.5
55073,2017,73896,71730,2166,2.9
55075,2017,19767,18892,875,4.4
55077,2017,7610,7317,293,3.9
55078,2017,1608,1513,95,5.9
55079,2017,475142,456025,19117,4
55081,2017,23529,22838,691,2.9
55083,2017,20655,19923,732,3.5
55085,2017,18372,17665,707,3.8
55087,2017,104011,100888,3123,3
55089,2017,49172,47823,1349,2.7
55091,2017,4218,4069,149,3.5
55093,2017,25177,24328,849,3.4
55095,2017,24858,23916,942,3.8
55097,2017,39636,38417,1219,3.1
55099,2017,6796,6542,254,3.7
55101,2017,99694,95664,4030,4
55103,2017,9290,9012,278,3
55105,2017,85290,82139,3151,3.7
55107,2017,6992,6681,311,4.4
55109,2017,50180,48615,1565,3.1
55111,2017,35550,34516,1034,2.9
55113,2017,8001,7627,374,4.7
55115,2017,21454,20764,690,3.2
55117,2017,62584,60854,1730,2.8
55119,2017,11118,10728,390,3.5
55121,2017,16477,15972,505,3.1
55123,2017,15738,15251,487,3.1
55125,2017,10168,9725,443,4.4
55127,2017,57960,56062,1898,3.3
55129,2017,7919,7607,312,3.9
55131,2017,77751,75596,2155,2.8
55133,2017,226155,219636,6519,2.9
55135,2017,26605,25759,846,3.2
55137,2017,11417,10963,454,4
55139,2017,93634,90853,2781,3
55141,2017,35031,33720,1311,3.7
56001,2017,20477,19893,584,2.9
56003,2017,5362,5135,227,4.2
56005,2017,23028,21912,1116,4.8
56007,2017,7903,7589,314,4
56009,2017,7483,7151,332,4.4
56011,2017,3687,3557,130,3.5
56013,2017,19356,18288,1068,5.5
56015,2017,6925,6727,198,2.9
56017,2017,2333,2242,91,3.9
56019,2017,4198,4023,175,4.2
56021,2017,48230,46472,1758,3.6
56023,2017,8752,8432,320,3.7
56025,2017,39535,37472,2063,5.2
56027,2017,1302,1266,36,2.8
56029,2017,15696,15031,665,4.2
56031,2017,4777,4601,176,3.7
56033,2017,15803,15190,613,3.9
56035,2017,4258,4068,190,4.5
56037,2017,21565,20591,974,4.5
56039,2017,15428,14994,434,2.8
56041,2017,9108,8695,413,4.5
56043,2017,4114,3950,164,4
56045,2017,3756,3608,148,3.9
72001,2017,4368,3710,658,15.1
72003,2017,11868,10334,1534,12.9
72005,2017,14891,12732,2159,14.5
72007,2017,6616,5789,827,12.5
72009,2017,6575,5643,932,14.2
72011,2017,8952,7831,1121,12.5
72013,2017,23532,20772,2760,11.7
72015,2017,5000,4113,887,17.7
72017,2017,5884,5060,824,14
72019,2017,7372,6535,837,11.4
72021,2017,64846,59877,4969,7.7
72023,2017,13946,12047,1899,13.6
72025,2017,47504,43195,4309,9.1
72027,2017,9387,8297,1090,11.6
72029,2017,16013,14452,1561,9.699999999999999
72031,2017,61105,56351,4754,7.8
72033,2017,7782,7076,706,9.1
72035,2017,16107,14479,1628,10.1
72037,2017,3774,3265,509,13.5
72039,2017,3834,3215,619,16.1
72041,2017,15246,13964,1282,8.4
72043,2017,10349,8669,1680,16.2
72045,2017,4948,4366,582,11.8
72047,2017,9013,7994,1019,11.3
72049,2017,912,872,40,4.4
72051,2017,12819,11936,883,6.9
72053,2017,11112,9630,1482,13.3
72054,2017,3359,2879,480,14.3
72055,2017,4053,3312,741,18.3
72057,2017,11746,9908,1838,15.6
72059,2017,5085,4251,834,16.4
72061,2017,36752,34813,1939,5.3
72063,2017,17559,16277,1282,7.3
72065,2017,13086,11258,1828,14
72067,2017,5538,4833,705,12.7
72069,2017,17374,14948,2426,14
72071,2017,12599,10912,1687,13.4
72073,2017,4249,3697,552,13
72075,2017,15029,13090,1939,12.9
72077,2017,12321,10898,1423,11.5
72079,2017,5473,4409,1064,19.4
72081,2017,7235,5888,1347,18.6
72083,2017,2802,2224,578,20.6
72085,2017,11244,9897,1347,12
72087,2017,8428,7619,809,9.6
72089,2017,6223,5424,799,12.8
72091,2017,11505,10282,1223,10.6
72093,2017,2024,1618,406,20.1
72095,2017,2949,2439,510,17.3
72097,2017,22579,19422,3157,14
72099,2017,10707,9133,1574,14.7
72101,2017,8028,7032,996,12.4
72103,2017,8013,7120,893,11.1
72105,2017,7155,6308,847,11.8
72107,2017,5096,4369,727,14.3
72109,2017,4643,3728,915,19.7
72111,2017,5994,4946,1048,17.5
72113,2017,45598,40291,5307,11.6
72115,2017,6062,5105,957,15.8
72117,2017,4664,3951,713,15.3
72119,2017,16953,15308,1645,9.699999999999999
72121,2017,6369,5296,1073,16.8
72123,2017,7481,6080,1401,18.7
72125,2017,10017,8447,1570,15.7
72127,2017,132504,123201,9303,7
72129,2017,11908,10381,1527,12.8
72131,2017,10576,8709,1867,17.7
72133,2017,9738,8420,1318,13.5
72135,2017,26566,24512,2054,7.7
72137,2017,29185,26823,2362,8.1
72139,2017,26623,25045,1578,5.9
72141,2017,6756,5813,943,14
72143,2017,9785,8738,1047,10.7
72145,2017,13414,11746,1668,12.4
72147,2017,3027,2589,438,14.5
72149,2017,7557,6090,1467,19.4
72151,2017,9000,7512,1488,16.5
72153,2017,10160,8409,1751,17.2
,,,,,
,,,,,
,,,,,
1001,2018,26196,25261,935,3.6
1003,2018,95233,91809,3424,3.6
1005,2018,8414,7987,427,5.1
1007,2018,8605,8268,337,3.9
1009,2018,25069,24201,868,3.5
1011,2018,4791,4571,220,4.6
1013,2018,8973,8553,420,4.7
1015,2018,46307,44191,2116,4.6
1017,2018,15366,14775,591,3.8
1019,2018,11688,11276,412,3.5
1021,2018,19624,18924,700,3.6
1023,2018,4749,4493,256,5.4
1025,2018,7659,7096,563,7.4
1027,2018,6010,5784,226,3.8
1029,2018,5795,5552,243,4.2
1031,2018,21007,20193,814,3.9
1033,2018,23541,22478,1063,4.5
1035,2018,4512,4281,231,5.1
1037,2018,4426,4246,180,4.1
1039,2018,15652,14945,707,4.5
1041,2018,6369,6114,255,4
1043,2018,38113,36879,1234,3.2
1045,2018,20257,19424,833,4.1
1047,2018,14880,13927,953,6.4
1049,2018,30289,29153,1136,3.8
1051,2018,37590,36313,1277,3.4
1053,2018,14423,13780,643,4.5
1055,2018,43252,41502,1750,4
1057,2018,6529,6267,262,4
1059,2018,14291,13768,523,3.7
1061,2018,10872,10450,422,3.9
1063,2018,2860,2672,188,6.6
1065,2018,5979,5680,299,5
1067,2018,6830,6531,299,4.4
1069,2018,45580,43764,1816,4
1071,2018,23412,22468,944,4
1073,2018,315793,304248,11545,3.7
1075,2018,5743,5528,215,3.7
1077,2018,42390,40644,1746,4.1
1079,2018,14044,13469,575,4.1
1081,2018,75243,72541,2702,3.6
1083,2018,42979,41472,1507,3.5
1085,2018,3614,3354,260,7.2
1087,2018,7862,7442,420,5.3
1089,2018,181565,175352,6213,3.4
1091,2018,7608,7237,371,4.9
1093,2018,12621,12114,507,4
1095,2018,42925,41496,1429,3.3
1097,2018,189004,180293,8711,4.6
1099,2018,7187,6753,434,6
1101,2018,105953,101782,4171,3.9
1103,2018,57158,55192,1966,3.4
1105,2018,3411,3192,219,6.4
1107,2018,7745,7395,350,4.5
1109,2018,15260,14579,681,4.5
1111,2018,9581,9202,379,4
1113,2018,24019,23067,952,4
1115,2018,40120,38742,1378,3.4
1117,2018,114634,111425,3209,2.8
1119,2018,4820,4543,277,5.7
1121,2018,35332,33847,1485,4.2
1123,2018,17959,17226,733,4.1
1125,2018,102508,98826,3682,3.6
1127,2018,25128,24078,1050,4.2
1129,2018,6711,6327,384,5.7
1131,2018,2756,2498,258,9.4
1133,2018,9810,9405,405,4.1
2013,2018,2292,2222,70,3.1
2016,2018,3602,3477,125,3.5
2020,2018,149431,141363,8068,5.4
2050,2018,7111,6209,902,12.7
2060,2018,444,417,27,6.1
2068,2018,1057,975,82,7.8
2070,2018,2004,1844,160,8
2090,2018,45476,42901,2575,5.7
2100,2018,1097,992,105,9.6
2105,2018,1146,1004,142,12.4
2110,2018,17045,16305,740,4.3
2122,2018,26372,24384,1988,7.5
2130,2018,6971,6556,415,6
2150,2018,6099,5744,355,5.8
2158,2018,2685,2160,525,19.6
2164,2018,741,660,81,10.9
2170,2018,47728,44184,3544,7.4
2180,2018,4082,3622,460,11.3
2185,2018,3387,3157,230,6.8
2188,2018,2916,2518,398,13.6
2195,2018,1379,1261,118,8.6
2198,2018,2872,2567,305,10.6
2220,2018,4331,4152,179,4.1
2230,2018,830,752,78,9.4
2240,2018,2925,2647,278,9.5
2261,2018,4828,4478,350,7.2
2275,2018,1033,962,71,6.9
2282,2018,246,226,20,8.1
2290,2018,2536,2165,371,14.6
4001,2018,20491,18485,2006,9.800000000000001
4003,2018,49482,46751,2731,5.5
4005,2018,76133,72001,4132,5.4
4007,2018,21357,20133,1224,5.7
4009,2018,14813,14071,742,5
4011,2018,4263,4089,174,4.1
4012,2018,8896,8351,545,6.1
4013,2018,2217163,2127021,90142,4.1
4015,2018,84938,80173,4765,5.6
4017,2018,40224,37173,3051,7.6
4019,2018,484209,463057,21152,4.4
4021,2018,179801,170951,8850,4.9
4023,2018,19252,17505,1747,9.1
4025,2018,104598,100023,4575,4.4
4027,2018,96960,80735,16225,16.7
5001,2018,9079,8779,300,3.3
5003,2018,7836,7425,411,5.2
5005,2018,16398,15729,669,4.1
5007,2018,134760,130888,3872,2.9
5009,2018,15912,15361,551,3.5
5011,2018,4486,4293,193,4.3
5013,2018,2445,2352,93,3.8
5015,2018,12619,12217,402,3.2
5017,2018,3359,3134,225,6.7
5019,2018,9700,9346,354,3.6
5021,2018,5806,5556,250,4.3
5023,2018,9129,8721,408,4.5
5025,2018,3268,3144,124,3.8
5027,2018,9025,8603,422,4.7
5029,2018,8174,7821,353,4.3
5031,2018,54562,52919,1643,3
5033,2018,27004,26054,950,3.5
5035,2018,21204,20294,910,4.3
5037,2018,7453,7150,303,4.1
5039,2018,2850,2730,120,4.2
5041,2018,5427,5186,241,4.4
5043,2018,7847,7468,379,4.8
5045,2018,62050,60058,1992,3.2
5047,2018,7385,7125,260,3.5
5049,2018,4823,4632,191,4
5051,2018,40826,39199,1627,4
5053,2018,8335,8079,256,3.1
5055,2018,19849,19165,684,3.4
5057,2018,9951,9607,344,3.5
5059,2018,13967,13447,520,3.7
5061,2018,5907,5706,201,3.4
5063,2018,16301,15648,653,4
5065,2018,4874,4610,264,5.4
5067,2018,5784,5437,347,6
5069,2018,28045,26595,1450,5.2
5071,2018,10401,9932,469,4.5
5073,2018,2492,2365,127,5.1
5075,2018,6826,6562,264,3.9
5077,2018,2903,2765,138,4.8
5079,2018,4013,3843,170,4.2
5081,2018,5465,5182,283,5.2
5083,2018,8744,8397,347,4
5085,2018,34206,33131,1075,3.1
5087,2018,7351,7140,211,2.9
5089,2018,6497,6231,266,4.1
5091,2018,19535,18602,933,4.8
5093,2018,17358,16386,972,5.6
5095,2018,2743,2629,114,4.2
5097,2018,3055,2912,143,4.7
5099,2018,3649,3524,125,3.4
5101,2018,3305,3195,110,3.3
5103,2018,9767,9323,444,4.5
5105,2018,4248,4075,173,4.1
5107,2018,6580,6185,395,6
5109,2018,4302,4129,173,4
5111,2018,10141,9756,385,3.8
5113,2018,8074,7745,329,4.1
5115,2018,29014,27739,1275,4.4
5117,2018,3560,3424,136,3.8
5119,2018,188642,182165,6477,3.4
5121,2018,7169,6886,283,3.9
5123,2018,8294,7876,418,5
5125,2018,58734,56950,1784,3
5127,2018,4393,4235,158,3.6
5129,2018,2928,2802,126,4.3
5131,2018,56858,54852,2006,3.5
5133,2018,5601,5347,254,4.5
5135,2018,5788,5514,274,4.7
5137,2018,4793,4579,214,4.5
5139,2018,15983,15113,870,5.4
5141,2018,5891,5583,308,5.2
5143,2018,122628,119442,3186,2.6
5145,2018,33643,32189,1454,4.3
5147,2018,2804,2673,131,4.7
5149,2018,8494,8142,352,4.1
6001,2018,842427,816611,25816,3.1
6003,2018,547,522,25,4.6
6005,2018,14686,14084,602,4.1
6007,2018,101932,96749,5183,5.1
6009,2018,21188,20329,859,4.1
6011,2018,10861,9421,1440,13.3
6013,2018,560913,542812,18101,3.2
6015,2018,9722,9163,559,5.7
6017,2018,91131,87804,3327,3.7
6019,2018,446744,412795,33949,7.6
6021,2018,12782,11938,844,6.6
6023,2018,62605,60329,2276,3.6
6025,2018,71243,57811,13432,18.9
6027,2018,8712,8371,341,3.9
6029,2018,386234,354890,31344,8.1
6031,2018,57568,53018,4550,7.9
6033,2018,29105,27558,1547,5.3
6035,2018,9866,9388,478,4.8
6037,2018,5095504,4860309,235195,4.6
6039,2018,61331,56955,4376,7.1
6041,2018,139858,136433,3425,2.4
6043,2018,7659,7248,411,5.4
6045,2018,39500,37913,1587,4
6047,2018,115380,105638,9742,8.4
6049,2018,3159,2919,240,7.6
6051,2018,8435,8092,343,4.1
6053,2018,222156,207917,14239,6.4
6055,2018,73861,71664,2197,3
6057,2018,48618,46904,1714,3.5
6059,2018,1617879,1569753,48126,3
6061,2018,185830,179858,5972,3.2
6063,2018,7823,7228,595,7.6
6065,2018,1091375,1042673,48702,4.5
6067,2018,704967,677544,27423,3.9
6069,2018,31236,29644,1592,5.1
6071,2018,956083,916705,39378,4.1
6073,2018,1581525,1528064,53461,3.4
6075,2018,569323,555609,13714,2.4
6077,2018,324531,304620,19911,6.1
6079,2018,140257,136020,4237,3
6081,2018,449479,439322,10157,2.3
6083,2018,215479,206909,8570,4
6085,2018,1043641,1015929,27712,2.7
6087,2018,141429,134349,7080,5
6089,2018,73978,70254,3724,5
6091,2018,1279,1201,78,6.1
6093,2018,17383,16205,1178,6.8
6095,2018,209280,200997,8283,4
6097,2018,260893,253626,7267,2.8
6099,2018,243356,227524,15832,6.5
6101,2018,44890,41449,3441,7.7
6103,2018,25517,24046,1471,5.8
6105,2018,4680,4410,270,5.8
6107,2018,203267,183303,19964,9.800000000000001
6109,2018,21212,20217,995,4.7
6111,2018,423557,407278,16279,3.8
6113,2018,107666,103019,4647,4.3
6115,2018,29275,27381,1894,6.5
8001,2018,269228,260239,8989,3.3
8003,2018,8566,8232,334,3.9
8005,2018,360142,349003,11139,3.1
8007,2018,6869,6640,229,3.3
8009,2018,2172,2133,39,1.8
8011,2018,1907,1847,60,3.1
8013,2018,192810,187527,5283,2.7
8014,2018,39581,38465,1116,2.8
8015,2018,9620,9369,251,2.6
8017,2018,1140,1120,20,1.8
8019,2018,5977,5802,175,2.9
8021,2018,4098,3930,168,4.1
8023,2018,1841,1762,79,4.3
8025,2018,1493,1430,63,4.2
8027,2018,2083,2009,74,3.6
8029,2018,14412,13852,560,3.9
8031,2018,411594,399026,12568,3.1
8033,2018,1148,1116,32,2.8
8035,2018,191729,186463,5266,2.7
8037,2018,36137,35195,942,2.6
8039,2018,15034,14628,406,2.7
8041,2018,335225,322516,12709,3.8
8043,2018,15054,14295,759,5
8045,2018,32376,31380,996,3.1
8047,2018,3724,3633,91,2.4
8049,2018,9912,9656,256,2.6
8051,2018,11349,11076,273,2.4
8053,2018,444,432,12,2.7
8055,2018,2584,2419,165,6.4
8057,2018,989,963,26,2.6
8059,2018,330997,321346,9651,2.9
8061,2018,944,927,17,1.8
8063,2018,4292,4207,85,2
8065,2018,4801,4678,123,2.6
8067,2018,32278,31354,924,2.9
8069,2018,201302,195848,5454,2.7
8071,2018,6553,6256,297,4.5
8073,2018,2460,2402,58,2.4
8075,2018,11216,10913,303,2.7
8077,2018,75614,72652,2962,3.9
8079,2018,511,498,13,2.5
8081,2018,7435,7171,264,3.6
8083,2018,12982,12379,603,4.6
8085,2018,21631,20861,770,3.6
8087,2018,16352,15892,460,2.8
8089,2018,8401,7990,411,4.9
8091,2018,2387,2307,80,3.4
8093,2018,11031,10729,302,2.7
8095,2018,2594,2546,48,1.9
8097,2018,11234,10821,413,3.7
8099,2018,6288,6087,201,3.2
8101,2018,75547,72004,3543,4.7
8103,2018,2940,2820,120,4.1
8105,2018,5425,5167,258,4.8
8107,2018,16238,15815,423,2.6
8109,2018,3535,3374,161,4.6
8111,2018,523,508,15,2.9
8113,2018,5563,5377,186,3.3
8115,2018,1189,1159,30,2.5
8117,2018,22506,22030,476,2.1
8119,2018,12542,12096,446,3.6
8121,2018,3055,2982,73,2.4
8123,2018,165053,160252,4801,2.9
8125,2018,6009,5893,116,1.9
9001,2018,479179,460045,19134,4
9003,2018,478660,458138,20522,4.3
9005,2018,104604,100568,4036,3.9
9007,2018,92811,89517,3294,3.5
9009,2018,458799,438485,20314,4.4
9011,2018,136856,131394,5462,4
9013,2018,86174,83055,3119,3.6
9015,2018,63584,60689,2895,4.6
10001,2018,78063,74802,3261,4.2
10003,2018,297784,286811,10973,3.7
10005,2018,105928,101930,3998,3.8
11001,2018,404739,381703,23036,5.7
12001,2018,137170,132623,4547,3.3
12003,2018,11631,11225,406,3.5
12005,2018,87904,84286,3618,4.1
12007,2018,11132,10751,381,3.4
12009,2018,276377,266476,9901,3.6
12011,2018,1031169,995853,35316,3.4
12013,2018,4938,4725,213,4.3
12015,2018,70712,67821,2891,4.1
12017,2018,47451,44929,2522,5.3
12019,2018,105706,102156,3550,3.4
12021,2018,177521,171288,6233,3.5
12023,2018,29385,28259,1126,3.8
12027,2018,13694,13145,549,4
12029,2018,5772,5526,246,4.3
12031,2018,482972,465288,17684,3.7
12033,2018,142919,137719,5200,3.6
12035,2018,46602,44659,1943,4.2
12037,2018,4720,4553,167,3.5
12039,2018,18356,17506,850,4.6
12041,2018,7021,6753,268,3.8
12043,2018,5221,5012,209,4
12045,2018,5991,5719,272,4.5
12047,2018,4366,4181,185,4.2
12049,2018,8797,8332,465,5.3
12051,2018,15609,14639,970,6.2
12053,2018,70560,67306,3254,4.6
12055,2018,36444,34647,1797,4.9
12057,2018,735639,710221,25418,3.5
12059,2018,6877,6601,276,4
12061,2018,64872,62028,2844,4.4
12063,2018,17221,16520,701,4.1
12065,2018,5564,5351,213,3.8
12067,2018,2825,2728,97,3.4
12069,2018,155380,149768,5612,3.6
12071,2018,340936,329035,11901,3.5
12073,2018,153740,148467,5273,3.4
12075,2018,16794,16132,662,3.9
12077,2018,2611,2507,104,4
12079,2018,7283,6994,289,4
12081,2018,177851,171675,6176,3.5
12083,2018,135616,129674,5942,4.4
12085,2018,72776,70156,2620,3.6
12086,2018,1362691,1315474,47217,3.5
12087,2018,45069,43899,1170,2.6
12089,2018,40458,39138,1320,3.3
12091,2018,95157,92257,2900,3
12093,2018,17692,17027,665,3.8
12095,2018,745550,721134,24416,3.3
12097,2018,180406,173698,6708,3.7
12099,2018,726179,699716,26463,3.6
12101,2018,233273,224130,9143,3.9
12103,2018,484489,468188,16301,3.4
12105,2018,298486,285973,12513,4.2
12107,2018,26723,25403,1320,4.9
12109,2018,130005,126180,3825,2.9
12111,2018,142566,136183,6383,4.5
12113,2018,81240,78497,2743,3.4
12115,2018,186958,180505,6453,3.5
12117,2018,249896,241721,8175,3.3
12119,2018,31285,29649,1636,5.2
12121,2018,18150,17469,681,3.8
12123,2018,8649,8314,335,3.9
12125,2018,4608,4457,151,3.3
12127,2018,252444,242811,9633,3.8
12129,2018,14724,14254,470,3.2
12131,2018,30972,29984,988,3.2
12133,2018,9746,9363,383,3.9
13001,2018,9003,8616,387,4.3
13003,2018,4334,4182,152,3.5
13005,2018,5007,4818,189,3.8
13007,2018,1157,1096,61,5.3
13009,2018,17583,16715,868,4.9
13011,2018,9492,9194,298,3.1
13013,2018,39906,38596,1310,3.3
13015,2018,49962,48075,1887,3.8
13017,2018,5453,5133,320,5.9
13019,2018,7431,7122,309,4.2
13021,2018,68732,65631,3101,4.5
13023,2018,4587,4323,264,5.8
13025,2018,7329,7002,327,4.5
13027,2018,6929,6656,273,3.9
13029,2018,18232,17618,614,3.4
13031,2018,36878,35309,1569,4.3
13033,2018,9215,8656,559,6.1
13035,2018,10636,10204,432,4.1
13037,2018,2233,2139,94,4.2
13039,2018,20799,19929,870,4.2
13043,2018,5320,5139,181,3.4
13045,2018,54655,52470,2185,4
13047,2018,33304,32173,1131,3.4
13049,2018,4782,4576,206,4.3
13051,2018,139311,134128,5183,3.7
13053,2018,2024,1913,111,5.5
13055,2018,10441,10016,425,4.1
13057,2018,134188,130011,4177,3.1
13059,2018,60536,58133,2403,4
13061,2018,844,781,63,7.5
13063,2018,136452,129776,6676,4.9
13065,2018,2747,2623,124,4.5
13067,2018,420300,405949,14351,3.4
13069,2018,18725,17886,839,4.5
13071,2018,21425,20623,802,3.7
13073,2018,75301,72695,2606,3.5
13075,2018,7807,7513,294,3.8
13077,2018,73745,71217,2528,3.4
13079,2018,5664,5429,235,4.1
13081,2018,9349,8898,451,4.8
13083,2018,8174,7876,298,3.6
13085,2018,12194,11789,405,3.3
13087,2018,11434,10902,532,4.7
13089,2018,395355,379404,15951,4
13091,2018,7126,6758,368,5.2
13093,2018,5095,4858,237,4.7
13095,2018,38394,36337,2057,5.4
13097,2018,72492,69493,2999,4.1
13099,2018,4510,4303,207,4.6
13101,2018,1908,1847,61,3.2
13103,2018,30787,29785,1002,3.3
13105,2018,7790,7417,373,4.8
13107,2018,8284,7795,489,5.9
13109,2018,4881,4701,180,3.7
13111,2018,11230,10786,444,4
13113,2018,57325,55327,1998,3.5
13115,2018,44146,42261,1885,4.3
13117,2018,120607,116807,3800,3.2
13119,2018,9973,9592,381,3.8
13121,2018,551054,528836,22218,4
13123,2018,11927,11428,499,4.2
13125,2018,1281,1228,53,4.1
13127,2018,39741,38277,1464,3.7
13129,2018,27362,26310,1052,3.8
13131,2018,10591,10184,407,3.8
13133,2018,7001,6703,298,4.3
13135,2018,484335,467318,17017,3.5
13137,2018,19318,18598,720,3.7
13139,2018,101542,98304,3238,3.2
13141,2018,2455,2309,146,5.9
13143,2018,12428,11950,478,3.8
13145,2018,16785,16216,569,3.4
13147,2018,11661,11238,423,3.6
13149,2018,5191,4990,201,3.9
13151,2018,114216,109509,4707,4.1
13153,2018,69830,67030,2800,4
13155,2018,3304,3118,186,5.6
13157,2018,36179,35069,1110,3.1
13159,2018,6858,6618,240,3.5
13161,2018,6047,5754,293,4.8
13163,2018,6674,6321,353,5.3
13165,2018,3164,2995,169,5.3
13167,2018,4076,3916,160,3.9
13169,2018,13836,13333,503,3.6
13171,2018,8168,7791,377,4.6
13173,2018,3771,3603,168,4.5
13175,2018,19344,18417,927,4.8
13177,2018,14725,14200,525,3.6
13179,2018,25717,24622,1095,4.3
13181,2018,3579,3404,175,4.9
13183,2018,8006,7690,316,3.9
13185,2018,51501,49411,2090,4.1
13187,2018,16628,16037,591,3.6
13189,2018,8873,8379,494,5.6
13191,2018,6220,5973,247,4
13193,2018,4673,4384,289,6.2
13195,2018,13610,13131,479,3.5
13197,2018,3353,3180,173,5.2
13199,2018,8817,8376,441,5
13201,2018,2755,2654,101,3.7
13205,2018,8324,7876,448,5.4
13207,2018,13121,12644,477,3.6
13209,2018,3837,3617,220,5.7
13211,2018,9142,8816,326,3.6
13213,2018,15904,15064,840,5.3
13215,2018,78351,74367,3984,5.1
13217,2018,51666,49358,2308,4.5
13219,2018,19976,19387,589,2.9
13221,2018,7086,6825,261,3.7
13223,2018,84923,82010,2913,3.4
13225,2018,11793,11184,609,5.2
13227,2018,15108,14574,534,3.5
13229,2018,8675,8348,327,3.8
13231,2018,8811,8495,316,3.6
13233,2018,18444,17671,773,4.2
13235,2018,4017,3842,175,4.4
13237,2018,8211,7804,407,5
13239,2018,821,775,46,5.6
13241,2018,7080,6798,282,4
13243,2018,2468,2331,137,5.6
13245,2018,85448,81021,4427,5.2
13247,2018,44312,42360,1952,4.4
13249,2018,2183,2083,100,4.6
13251,2018,5255,4972,283,5.4
13253,2018,3026,2865,161,5.3
13255,2018,28417,27079,1338,4.7
13257,2018,10892,10395,497,4.6
13259,2018,2353,2240,113,4.8
13261,2018,12629,11880,749,5.9
13263,2018,2817,2676,141,5
13265,2018,565,535,30,5.3
13267,2018,9630,9226,404,4.2
13269,2018,2768,2589,179,6.5
13271,2018,4333,4043,290,6.7
13273,2018,3553,3316,237,6.7
13275,2018,16783,15999,784,4.7
13277,2018,19241,18474,767,4
13279,2018,11799,11115,684,5.8
13281,2018,3890,3672,218,5.6
13283,2018,2692,2536,156,5.8
13285,2018,36464,35125,1339,3.7
13287,2018,3156,2997,159,5
13289,2018,2906,2735,171,5.9
13291,2018,10272,9896,376,3.7
13293,2018,11308,10813,495,4.4
13295,2018,31113,29917,1196,3.8
13297,2018,45479,43862,1617,3.6
13299,2018,15489,14883,606,3.9
13301,2018,2738,2603,135,4.9
13303,2018,7107,6752,355,5
13305,2018,11334,10807,527,4.6
13307,2018,993,931,62,6.2
13309,2018,1657,1536,121,7.3
13311,2018,16072,15585,487,3
13313,2018,44754,42628,2126,4.8
13315,2018,2665,2526,139,5.2
13317,2018,3802,3626,176,4.6
13319,2018,3822,3653,169,4.4
13321,2018,8898,8503,395,4.4
15001,2018,92451,89660,2791,3
15003,2018,458052,446999,11053,2.4
15007,2018,36599,35672,927,2.5
15009,2018,88083,85925,2158,2.4
16001,2018,244766,238575,6191,2.5
16003,2018,1719,1624,95,5.5
16005,2018,41733,40564,1169,2.8
16007,2018,2856,2773,83,2.9
16009,2018,4018,3831,187,4.7
16011,2018,23303,22657,646,2.8
16013,2018,12336,12036,300,2.4
16015,2018,3388,3243,145,4.3
16017,2018,19675,18851,824,4.2
16019,2018,55200,53842,1358,2.5
16021,2018,5265,5028,237,4.5
16023,2018,1363,1318,45,3.3
16025,2018,688,672,16,2.3
16027,2018,100631,97447,3184,3.2
16029,2018,3871,3761,110,2.8
16031,2018,11783,11516,267,2.3
16033,2018,381,370,11,2.9
16035,2018,2916,2714,202,6.9
16037,2018,2186,2095,91,4.2
16039,2018,11402,11022,380,3.3
16041,2018,6871,6720,151,2.2
16043,2018,7776,7584,192,2.5
16045,2018,8054,7769,285,3.5
16047,2018,8096,7898,198,2.4
16049,2018,6433,6128,305,4.7
16051,2018,13611,13297,314,2.3
16053,2018,11977,11667,310,2.6
16055,2018,77763,74997,2766,3.6
16057,2018,20185,19674,511,2.5
16059,2018,3508,3349,159,4.5
16061,2018,1620,1528,92,5.7
16063,2018,2705,2611,94,3.5
16065,2018,21641,21262,379,1.8
16067,2018,11033,10752,281,2.5
16069,2018,20961,20373,588,2.8
16071,2018,2331,2279,52,2.2
16073,2018,5411,5212,199,3.7
16075,2018,11553,11130,423,3.7
16077,2018,4080,3959,121,3
16079,2018,5073,4776,297,5.9
16081,2018,6412,6264,148,2.3
16083,2018,40660,39542,1118,2.7
16085,2018,5349,5144,205,3.8
16087,2018,4628,4434,194,4.2
17001,2018,32935,31689,1246,3.8
17003,2018,2070,1904,166,8
17005,2018,7809,7474,335,4.3
17007,2018,26624,25129,1495,5.6
17009,2018,2886,2812,74,2.6
17011,2018,17510,16659,851,4.9
17013,2018,2332,2210,122,5.2
17015,2018,7484,7157,327,4.4
17017,2018,6138,5867,271,4.4
17019,2018,108065,103473,4592,4.2
17021,2018,14822,14060,762,5.1
17023,2018,7804,7409,395,5.1
17025,2018,6687,6343,344,5.1
17027,2018,20465,19750,715,3.5
17029,2018,24227,23106,1121,4.6
17031,2018,2602134,2494216,107918,4.1
17033,2018,8728,8271,457,5.2
17035,2018,6106,5867,239,3.9
17037,2018,55294,52902,2392,4.3
17039,2018,7575,7200,375,5
17041,2018,10305,9895,410,4
17043,2018,508812,492484,16328,3.2
17045,2018,9289,8866,423,4.6
17047,2018,2782,2660,122,4.4
17049,2018,19207,18505,702,3.7
17051,2018,9811,9308,503,5.1
17053,2018,6441,6142,299,4.6
17055,2018,16908,15884,1024,6.1
17057,2018,15283,14355,928,6.1
17059,2018,2444,2307,137,5.6
17061,2018,6019,5732,287,4.8
17063,2018,25504,24284,1220,4.8
17065,2018,4482,4288,194,4.3
17067,2018,8505,8115,390,4.6
17069,2018,1335,1234,101,7.6
17071,2018,3664,3486,178,4.9
17073,2018,25120,23886,1234,4.9
17075,2018,14485,13855,630,4.3
17077,2018,28082,26831,1251,4.5
17079,2018,4617,4391,226,4.9
17081,2018,17781,16863,918,5.2
17083,2018,10998,10474,524,4.8
17085,2018,11056,10585,471,4.3
17087,2018,4120,3814,306,7.4
17089,2018,274172,260970,13202,4.8
17091,2018,55566,52565,3001,5.4
17093,2018,68692,66235,2457,3.6
17095,2018,22181,21029,1152,5.2
17097,2018,377827,361032,16795,4.4
17099,2018,56128,52942,3186,5.7
17101,2018,5999,5658,341,5.7
17103,2018,17937,17164,773,4.3
17105,2018,16675,15963,712,4.3
17107,2018,12927,12336,591,4.6
17109,2018,13383,12731,652,4.9
17111,2018,165900,159952,5948,3.6
17113,2018,89103,85473,3630,4.1
17115,2018,49954,47223,2731,5.5
17117,2018,23079,21966,1113,4.8
17119,2018,134541,128575,5966,4.4
17121,2018,17872,17014,858,4.8
17123,2018,5437,5157,280,5.1
17125,2018,6318,5949,369,5.8
17127,2018,5722,5330,392,6.9
17129,2018,6599,6336,263,4
17131,2018,8142,7724,418,5.1
17133,2018,18788,18153,635,3.4
17135,2018,11925,11235,690,5.8
17137,2018,16411,15698,713,4.3
17139,2018,7524,7241,283,3.8
17141,2018,25482,24237,1245,4.9
17143,2018,86510,81781,4729,5.5
17145,2018,8460,7967,493,5.8
17147,2018,8566,8211,355,4.1
17149,2018,7223,6883,340,4.7
17151,2018,1759,1657,102,5.8
17153,2018,2073,1910,163,7.9
17155,2018,3043,2885,158,5.2
17157,2018,14212,13598,614,4.3
17159,2018,7510,7168,342,4.6
17161,2018,71634,67966,3668,5.1
17163,2018,126913,120630,6283,5
17165,2018,9865,9238,627,6.4
17167,2018,102571,98154,4417,4.3
17169,2018,3341,3196,145,4.3
17171,2018,2487,2359,128,5.1
17173,2018,10744,10292,452,4.2
17175,2018,2591,2432,159,6.1
17177,2018,22192,21173,1019,4.6
17179,2018,64991,61874,3117,4.8
17181,2018,7456,6985,471,6.3
17183,2018,33569,31551,2018,6
17185,2018,5796,5533,263,4.5
17187,2018,8718,8360,358,4.1
17189,2018,9879,9593,286,2.9
17191,2018,6915,6538,377,5.5
17193,2018,6724,6445,279,4.1
17195,2018,28620,27349,1271,4.4
17197,2018,357854,343007,14847,4.1
17199,2018,32154,30551,1603,5
17201,2018,141472,133567,7905,5.6
17203,2018,19093,18326,767,4
18001,2018,17489,17026,463,2.6
18003,2018,184636,178696,5940,3.2
18005,2018,45116,43908,1208,2.7
18007,2018,4561,4411,150,3.3
18009,2018,5322,5114,208,3.9
18011,2018,36188,35194,994,2.7
18013,2018,7692,7444,248,3.2
18015,2018,10225,9885,340,3.3
18017,2018,18254,17573,681,3.7
18019,2018,61874,59724,2150,3.5
18021,2018,12325,11837,488,4
18023,2018,17180,16687,493,2.9
18025,2018,4950,4725,225,4.5
18027,2018,16508,16054,454,2.8
18029,2018,25872,24913,959,3.7
18031,2018,14943,14491,452,3
18033,2018,22497,21850,647,2.9
18035,2018,54144,51938,2206,4.1
18037,2018,23328,22742,586,2.5
18039,2018,115999,112944,3055,2.6
18041,2018,9156,8726,430,4.7
18043,2018,41805,40407,1398,3.3
18045,2018,8095,7798,297,3.7
18047,2018,11401,10972,429,3.8
18049,2018,9999,9658,341,3.4
18051,2018,19427,18902,525,2.7
18053,2018,32169,30916,1253,3.9
18055,2018,13739,13124,615,4.5
18057,2018,182986,177963,5023,2.7
18059,2018,40131,38898,1233,3.1
18061,2018,20413,19699,714,3.5
18063,2018,89577,86951,2626,2.9
18065,2018,22418,21621,797,3.6
18067,2018,37427,35875,1552,4.1
18069,2018,18378,17719,659,3.6
18071,2018,22818,22158,660,2.9
18073,2018,16469,15815,654,4
18075,2018,9777,9449,328,3.4
18077,2018,15107,14585,522,3.5
18079,2018,13599,13099,500,3.7
18081,2018,82656,80240,2416,2.9
18083,2018,18851,18246,605,3.2
18085,2018,42731,41592,1139,2.7
18087,2018,20641,20118,523,2.5
18089,2018,231860,220240,11620,5
18091,2018,48085,45961,2124,4.4
18093,2018,21129,20307,822,3.9
18095,2018,58987,56649,2338,4
18097,2018,488698,471316,17382,3.6
18099,2018,23363,22613,750,3.2
18101,2018,5217,5071,146,2.8
18103,2018,15830,15188,642,4.1
18105,2018,69558,67018,2540,3.7
18107,2018,19104,18517,587,3.1
18109,2018,36280,35030,1250,3.4
18111,2018,7056,6745,311,4.4
18113,2018,23649,22947,702,3
18115,2018,3189,3075,114,3.6
18117,2018,8570,8231,339,4
18119,2018,9338,8926,412,4.4
18121,2018,7152,6861,291,4.1
18123,2018,9330,8981,349,3.7
18125,2018,6136,5919,217,3.5
18127,2018,87378,83988,3390,3.9
18129,2018,13715,13323,392,2.9
18131,2018,6507,6303,204,3.1
18133,2018,16770,16126,644,3.8
18135,2018,11615,11156,459,4
18137,2018,14106,13592,514,3.6
18139,2018,9037,8775,262,2.9
18141,2018,136494,131569,4925,3.6
18143,2018,10623,10204,419,3.9
18145,2018,23094,22365,729,3.2
18147,2018,10979,10614,365,3.3
18149,2018,10409,9949,460,4.4
18151,2018,20315,19766,549,2.7
18153,2018,8597,8191,406,4.7
18155,2018,5072,4872,200,3.9
18157,2018,98133,94963,3170,3.2
18159,2018,9234,8973,261,2.8
18161,2018,3564,3450,114,3.2
18163,2018,95029,91968,3061,3.2
18165,2018,7161,6762,399,5.6
18167,2018,49125,46941,2184,4.4
18169,2018,14991,14467,524,3.5
18171,2018,4207,4070,137,3.3
18173,2018,33209,32221,988,3
18175,2018,13828,13335,493,3.6
18177,2018,31261,30124,1137,3.6
18179,2018,14396,13985,411,2.9
18181,2018,13682,13257,425,3.1
18183,2018,17671,17157,514,2.9
19001,2018,4136,4035,101,2.4
19003,2018,2117,2075,42,2
19005,2018,7374,7141,233,3.2
19007,2018,5890,5687,203,3.4
19009,2018,3090,3012,78,2.5
19011,2018,13339,12965,374,2.8
19013,2018,68546,66567,1979,2.9
19015,2018,14843,14515,328,2.2
19017,2018,13807,13516,291,2.1
19019,2018,11221,10924,297,2.6
19021,2018,11541,11292,249,2.2
19023,2018,7819,7597,222,2.8
19025,2018,4285,4173,112,2.6
19027,2018,10819,10611,208,1.9
19029,2018,7104,6909,195,2.7
19031,2018,10785,10514,271,2.5
19033,2018,23294,22665,629,2.7
19035,2018,5984,5851,133,2.2
19037,2018,6417,6239,178,2.8
19039,2018,4817,4676,141,2.9
19041,2018,8529,8246,283,3.3
19043,2018,10144,9813,331,3.3
19045,2018,22685,21931,754,3.3
19047,2018,8166,7880,286,3.5
19049,2018,48655,47789,866,1.8
19051,2018,4211,4094,117,2.8
19053,2018,4332,4231,101,2.3
19055,2018,10433,10210,223,2.1
19057,2018,19441,18784,657,3.4
19059,2018,9844,9522,322,3.3
19061,2018,55332,53949,1383,2.5
19063,2018,5298,5148,150,2.8
19065,2018,10515,10193,322,3.1
19067,2018,8825,8580,245,2.8
19069,2018,5779,5653,126,2.2
19071,2018,3717,3645,72,1.9
19073,2018,5390,5264,126,2.3
19075,2018,6507,6339,168,2.6
19077,2018,5539,5390,149,2.7
19079,2018,6947,6754,193,2.8
19081,2018,5971,5828,143,2.4
19083,2018,8245,8003,242,2.9
19085,2018,7256,7089,167,2.3
19087,2018,9718,9471,247,2.5
19089,2018,5186,5051,135,2.6
19091,2018,5191,5057,134,2.6
19093,2018,4092,4009,83,2
19095,2018,10427,10204,223,2.1
19097,2018,10946,10633,313,2.9
19099,2018,19356,18828,528,2.7
19101,2018,9724,9498,226,2.3
19103,2018,85689,83976,1713,2
19105,2018,10576,10251,325,3.1
19107,2018,5149,4996,153,3
19109,2018,8508,8330,178,2.1
19111,2018,15963,15301,662,4.1
19113,2018,120292,116835,3457,2.9
19115,2018,6055,5890,165,2.7
19117,2018,4493,4401,92,2
19119,2018,6983,6873,110,1.6
19121,2018,8425,8149,276,3.3
19123,2018,11701,11402,299,2.6
19125,2018,17876,17497,379,2.1
19127,2018,18038,17211,827,4.6
19129,2018,7269,7111,158,2.2
19131,2018,5920,5810,110,1.9
19133,2018,4453,4327,126,2.8
19135,2018,3901,3783,118,3
19137,2018,4927,4803,124,2.5
19139,2018,21771,21173,598,2.7
19141,2018,8109,7943,166,2
19143,2018,3519,3449,70,2
19145,2018,6394,6229,165,2.6
19147,2018,4863,4753,110,2.3
19149,2018,14664,14375,289,2
19151,2018,4345,4264,81,1.9
19153,2018,264091,257086,7005,2.7
19155,2018,47670,46511,1159,2.4
19157,2018,10461,10207,254,2.4
19159,2018,2526,2454,72,2.9
19161,2018,5294,5165,129,2.4
19163,2018,87810,85144,2666,3
19165,2018,6651,6514,137,2.1
19167,2018,20487,20110,377,1.8
19169,2018,57864,56909,955,1.7
19171,2018,9487,9196,291,3.1
19173,2018,3236,3170,66,2
19175,2018,6372,6139,233,3.7
19177,2018,3712,3610,102,2.7
19179,2018,17677,17051,626,3.5
19181,2018,27787,27130,657,2.4
19183,2018,11969,11676,293,2.4
19185,2018,2768,2690,78,2.8
19187,2018,19164,18519,645,3.4
19189,2018,5001,4867,134,2.7
19191,2018,11787,11463,324,2.7
19193,2018,55010,53584,1426,2.6
19195,2018,4167,4050,117,2.8
19197,2018,6462,6289,173,2.7
20001,2018,6323,6076,247,3.9
20003,2018,4113,3973,140,3.4
20005,2018,6997,6681,316,4.5
20007,2018,2377,2318,59,2.5
20009,2018,13510,13081,429,3.2
20011,2018,7078,6788,290,4.1
20013,2018,5360,5200,160,3
20015,2018,31912,30836,1076,3.4
20017,2018,1464,1426,38,2.6
20019,2018,1412,1357,55,3.9
20021,2018,10019,9652,367,3.7
20023,2018,1308,1278,30,2.3
20025,2018,1061,1036,25,2.4
20027,2018,3779,3660,119,3.1
20029,2018,3779,3652,127,3.4
20031,2018,4080,3891,189,4.6
20033,2018,883,862,21,2.4
20035,2018,16769,16208,561,3.3
20037,2018,18732,18000,732,3.9
20039,2018,1251,1215,36,2.9
20041,2018,9091,8779,312,3.4
20043,2018,4144,3999,145,3.5
20045,2018,65119,63156,1963,3
20047,2018,1491,1456,35,2.3
20049,2018,1167,1128,39,3.3
20051,2018,16886,16493,393,2.3
20053,2018,2681,2608,73,2.7
20055,2018,20451,19954,497,2.4
20057,2018,17228,16801,427,2.5
20059,2018,13999,13507,492,3.5
20061,2018,11395,10868,527,4.6
20063,2018,1415,1385,30,2.1
20065,2018,1138,1103,35,3.1
20067,2018,3335,3244,91,2.7
20069,2018,3403,3336,67,2
20071,2018,855,838,17,2
20073,2018,3228,3117,111,3.4
20075,2018,1620,1589,31,1.9
20077,2018,2731,2655,76,2.8
20079,2018,16719,16190,529,3.2
20081,2018,2190,2144,46,2.1
20083,2018,982,958,24,2.4
20085,2018,7176,6965,211,2.9
20087,2018,10124,9803,321,3.2
20089,2018,1282,1248,34,2.7
20091,2018,335617,326067,9550,2.8
20093,2018,2079,2032,47,2.3
20095,2018,3389,3282,107,3.2
20097,2018,1299,1268,31,2.4
20099,2018,10181,9785,396,3.9
20101,2018,788,766,22,2.8
20103,2018,36155,34856,1299,3.6
20105,2018,1696,1655,41,2.4
20107,2018,4402,4146,256,5.8
20109,2018,1680,1645,35,2.1
20111,2018,16548,15975,573,3.5
20113,2018,16468,16059,409,2.5
20115,2018,6015,5831,184,3.1
20117,2018,5466,5326,140,2.6
20119,2018,2271,2225,46,2
20121,2018,17341,16726,615,3.5
20123,2018,3440,3365,75,2.2
20125,2018,14726,14106,620,4.2
20127,2018,2994,2914,80,2.7
20129,2018,1166,1129,37,3.2
20131,2018,5460,5336,124,2.3
20133,2018,5976,5691,285,4.8
20135,2018,1330,1295,35,2.6
20137,2018,2736,2679,57,2.1
20139,2018,8003,7706,297,3.7
20141,2018,2036,1986,50,2.5
20143,2018,3000,2917,83,2.8
20145,2018,2902,2812,90,3.1
20147,2018,2766,2698,68,2.5
20149,2018,12442,12105,337,2.7
20151,2018,4938,4806,132,2.7
20153,2018,1470,1440,30,2
20155,2018,29591,28544,1047,3.5
20157,2018,2407,2343,64,2.7
20159,2018,5272,5121,151,2.9
20161,2018,35134,34146,988,2.8
20163,2018,2510,2432,78,3.1
20165,2018,1647,1603,44,2.7
20167,2018,3358,3261,97,2.9
20169,2018,30165,29266,899,3
20171,2018,2849,2794,55,1.9
20173,2018,246776,237636,9140,3.7
20175,2018,9544,9242,302,3.2
20177,2018,90498,87401,3097,3.4
20179,2018,1418,1387,31,2.2
20181,2018,2887,2808,79,2.7
20183,2018,1960,1913,47,2.4
20185,2018,1966,1915,51,2.6
20187,2018,999,974,25,2.5
20189,2018,2592,2518,74,2.9
20191,2018,10719,10349,370,3.5
20193,2018,4257,4151,106,2.5
20195,2018,1376,1334,42,3.1
20197,2018,3652,3539,113,3.1
20199,2018,819,799,20,2.4
20201,2018,2926,2849,77,2.6
20203,2018,1314,1287,27,2.1
20205,2018,4000,3829,171,4.3
20207,2018,1592,1524,68,4.3
20209,2018,76791,73124,3667,4.8
21001,2018,7203,6845,358,5
21003,2018,8925,8588,337,3.8
21005,2018,11916,11487,429,3.6
21007,2018,3538,3291,247,7
21009,2018,19055,18208,847,4.4
21011,2018,4615,4303,312,6.8
21013,2018,8489,7957,532,6.3
21015,2018,70694,68308,2386,3.4
21017,2018,9700,9313,387,4
21019,2018,17944,16882,1062,5.9
21021,2018,12575,12016,559,4.4
21023,2018,3814,3627,187,4.9
21025,2018,3623,3360,263,7.3
21027,2018,7954,7525,429,5.4
21029,2018,42769,41040,1729,4
21031,2018,5111,4859,252,4.9
21033,2018,5391,5134,257,4.8
21035,2018,18760,18025,735,3.9
21037,2018,50542,48876,1666,3.3
21039,2018,2258,2146,112,5
21041,2018,5254,5038,216,4.1
21043,2018,9846,8938,908,9.199999999999999
21045,2018,6720,6405,315,4.7
21047,2018,24569,23250,1319,5.4
21049,2018,17155,16446,709,4.1
21051,2018,5220,4853,367,7
21053,2018,3871,3660,211,5.5
21055,2018,3867,3668,199,5.1
21057,2018,3122,2983,139,4.5
21059,2018,47505,45602,1903,4
21061,2018,4816,4559,257,5.3
21063,2018,2053,1861,192,9.4
21065,2018,5324,5034,290,5.4
21067,2018,174380,168569,5811,3.3
21069,2018,6087,5754,333,5.5
21071,2018,10928,10214,714,6.5
21073,2018,25006,24075,931,3.7
21075,2018,2034,1918,116,5.7
21077,2018,4071,3906,165,4.1
21079,2018,7671,7328,343,4.5
21081,2018,11711,11207,504,4.3
21083,2018,15479,14704,775,5
21085,2018,10968,10430,538,4.9
21087,2018,5084,4868,216,4.2
21089,2018,13448,12561,887,6.6
21091,2018,3997,3828,169,4.2
21093,2018,48964,46960,2004,4.1
21095,2018,6549,6069,480,7.3
21097,2018,8656,8298,358,4.1
21099,2018,8054,7732,322,4
21101,2018,22011,21166,845,3.8
21103,2018,8231,7915,316,3.8
21105,2018,1795,1693,102,5.7
21107,2018,18410,17561,849,4.6
21109,2018,4096,3809,287,7
21111,2018,400457,384240,16217,4
21113,2018,26475,25510,965,3.6
21115,2018,6769,6308,461,6.8
21117,2018,87423,84408,3015,3.4
21119,2018,4411,4110,301,6.8
21121,2018,10012,9381,631,6.3
21123,2018,5981,5714,267,4.5
21125,2018,24832,23561,1271,5.1
21127,2018,5071,4704,367,7.2
21129,2018,2086,1952,134,6.4
21131,2018,2623,2437,186,7.1
21133,2018,6257,5855,402,6.4
21135,2018,4707,4314,393,8.300000000000001
21137,2018,9356,8884,472,5
21139,2018,3671,3422,249,6.8
21141,2018,12428,11947,481,3.9
21143,2018,3053,2899,154,5
21145,2018,29206,27572,1634,5.6
21147,2018,4637,4345,292,6.3
21149,2018,4237,4026,211,5
21151,2018,46933,45118,1815,3.9
21153,2018,2933,2556,377,12.9
21155,2018,9644,9282,362,3.8
21157,2018,14971,14175,796,5.3
21159,2018,2799,2620,179,6.4
21161,2018,7187,6788,399,5.6
21163,2018,12260,11687,573,4.7
21165,2018,2320,2143,177,7.6
21167,2018,9911,9471,440,4.4
21169,2018,4120,3947,173,4.2
21171,2018,4700,4504,196,4.2
21173,2018,11680,10984,696,6
21175,2018,4479,4194,285,6.4
21177,2018,10557,9848,709,6.7
21179,2018,22726,21742,984,4.3
21181,2018,3286,3134,152,4.6
21183,2018,9878,9314,564,5.7
21185,2018,33311,32218,1093,3.3
21187,2018,5212,4954,258,5
21189,2018,1139,1055,84,7.4
21191,2018,6991,6702,289,4.1
21193,2018,8167,7654,513,6.3
21195,2018,20001,18827,1174,5.9
21197,2018,5022,4723,299,6
21199,2018,26035,24726,1309,5
21201,2018,802,763,39,4.9
21203,2018,6641,6310,331,5
21205,2018,10537,9990,547,5.2
21207,2018,6284,5920,364,5.8
21209,2018,28967,28006,961,3.3
21211,2018,25494,24614,880,3.5
21213,2018,8861,8511,350,3.9
21215,2018,10219,9850,369,3.6
21217,2018,12558,12029,529,4.2
21219,2018,5303,5091,212,4
21221,2018,5913,5627,286,4.8
21223,2018,3872,3707,165,4.3
21225,2018,6014,5716,298,5
21227,2018,64620,62234,2386,3.7
21229,2018,6143,5918,225,3.7
21231,2018,7586,7058,528,7
21233,2018,5782,5538,244,4.2
21235,2018,13752,13059,693,5
21237,2018,1903,1757,146,7.7
21239,2018,14767,14309,458,3.1
22001,2018,23897,22614,1283,5.4
22003,2018,8761,8265,496,5.7
22005,2018,64198,61565,2633,4.1
22007,2018,8960,8365,595,6.6
22009,2018,15303,14434,869,5.7
22011,2018,14574,13800,774,5.3
22013,2018,5637,5309,328,5.8
22015,2018,57953,55487,2466,4.3
22017,2018,104208,98488,5720,5.5
22019,2018,109755,105554,4201,3.8
22021,2018,3832,3612,220,5.7
22023,2018,4073,3929,144,3.5
22025,2018,3357,3131,226,6.7
22027,2018,5806,5505,301,5.2
22029,2018,6999,6513,486,6.9
22031,2018,10891,10269,622,5.7
22033,2018,231205,221219,9986,4.3
22035,2018,1952,1752,200,10.2
22037,2018,8006,7635,371,4.6
22039,2018,12089,11397,692,5.7
22041,2018,7268,6748,520,7.2
22043,2018,8205,7729,476,5.8
22045,2018,28270,26612,1658,5.9
22047,2018,14138,13264,874,6.2
22049,2018,6874,6556,318,4.6
22051,2018,213281,203937,9344,4.4
22053,2018,13499,12860,639,4.7
22055,2018,113928,108850,5078,4.5
22057,2018,42076,40098,1978,4.7
22059,2018,6349,6073,276,4.3
22061,2018,21979,20844,1135,5.2
22063,2018,68941,66166,2775,4
22065,2018,3609,3310,299,8.300000000000001
22067,2018,10156,9326,830,8.199999999999999
22069,2018,16420,15463,957,5.8
22071,2018,178349,169410,8939,5
22073,2018,70832,67193,3639,5.1
22075,2018,10051,9585,466,4.6
22077,2018,9906,9374,532,5.4
22079,2018,55421,52500,2921,5.3
22081,2018,4047,3867,180,4.4
22083,2018,8310,7793,517,6.2
22085,2018,9028,8562,466,5.2
22087,2018,19795,18806,989,5
22089,2018,25044,23952,1092,4.4
22091,2018,4310,4028,282,6.5
22093,2018,9215,8642,573,6.2
22095,2018,19584,18471,1113,5.7
22097,2018,31918,29929,1989,6.2
22099,2018,22267,21100,1167,5.2
22101,2018,20056,18747,1309,6.5
22103,2018,118816,113852,4964,4.2
22105,2018,54498,51501,2997,5.5
22107,2018,1444,1333,111,7.7
22109,2018,46438,44121,2317,5
22111,2018,9194,8678,516,5.6
22113,2018,24180,22897,1283,5.3
22115,2018,15919,14887,1032,6.5
22117,2018,16817,15849,968,5.8
22119,2018,14587,13698,889,6.1
22121,2018,13684,13081,603,4.4
22123,2018,3999,3641,358,9
22125,2018,5387,5178,209,3.9
22127,2018,4950,4644,306,6.2
23001,2018,55239,53489,1750,3.2
23003,2018,30867,29437,1430,4.6
23005,2018,164612,160364,4248,2.6
23007,2018,14383,13829,554,3.9
23009,2018,29374,28300,1074,3.7
23011,2018,62180,60236,1944,3.1
23013,2018,20575,19942,633,3.1
23015,2018,16933,16388,545,3.2
23017,2018,26617,25601,1016,3.8
23019,2018,76597,73830,2767,3.6
23021,2018,7440,7143,297,4
23023,2018,19480,18972,508,2.6
23025,2018,22732,21679,1053,4.6
23027,2018,21123,20405,718,3.4
23029,2018,13850,13191,659,4.8
23031,2018,113678,110344,3334,2.9
24001,2018,32184,30406,1778,5.5
24003,2018,313955,303453,10502,3.3
24005,2018,452381,433980,18401,4.1
24009,2018,49845,48075,1770,3.6
24011,2018,18272,17572,700,3.8
24013,2018,95556,92453,3103,3.2
24015,2018,52984,50629,2355,4.4
24017,2018,86841,83484,3357,3.9
24019,2018,15587,14776,811,5.2
24021,2018,134003,129307,4696,3.5
24023,2018,15597,14852,745,4.8
24025,2018,140424,135326,5098,3.6
24027,2018,186777,181148,5629,3
24029,2018,10354,9904,450,4.3
24031,2018,557200,539485,17715,3.2
24033,2018,507208,486413,20795,4.1
24035,2018,27887,26953,934,3.3
24037,2018,55898,53762,2136,3.8
24039,2018,9246,8597,649,7
24041,2018,19739,18999,740,3.7
24043,2018,74876,71573,3303,4.4
24045,2018,51021,48302,2719,5.3
24047,2018,25532,23450,2082,8.199999999999999
24510,2018,288238,271672,16566,5.7
25001,2018,115315,110350,4965,4.3
25003,2018,65331,62661,2670,4.1
25005,2018,302784,289824,12960,4.3
25007,2018,9717,9269,448,4.6
25009,2018,427449,412710,14739,3.4
25011,2018,41118,39868,1250,3
25013,2018,229722,219067,10655,4.6
25015,2018,90562,87804,2758,3
25017,2018,918508,893485,25023,2.7
25019,2018,7538,7205,333,4.4
25021,2018,390559,378881,11678,3
25023,2018,283373,273402,9971,3.5
25025,2018,455039,441272,13767,3
25027,2018,448477,432490,15987,3.6
26001,2018,3807,3557,250,6.6
26003,2018,3208,2954,254,7.9
26005,2018,61917,59880,2037,3.3
26007,2018,13333,12649,684,5.1
26009,2018,10053,9483,570,5.7
26011,2018,5963,5540,423,7.1
26013,2018,3155,2962,193,6.1
26015,2018,31627,30547,1080,3.4
26017,2018,50324,47907,2417,4.8
26019,2018,8778,8292,486,5.5
26021,2018,73234,70071,3163,4.3
26023,2018,19314,18594,720,3.7
26025,2018,63021,60362,2659,4.2
26027,2018,24427,23430,997,4.1
26029,2018,13098,12471,627,4.8
26031,2018,10695,9711,984,9.199999999999999
26033,2018,16222,15142,1080,6.7
26035,2018,11800,11077,723,6.1
26037,2018,41080,39769,1311,3.2
26039,2018,5534,5202,332,6
26041,2018,17016,16109,907,5.3
26043,2018,12517,12038,479,3.8
26045,2018,57163,55166,1997,3.5
26047,2018,17678,16636,1042,5.9
26049,2018,182278,173338,8940,4.9
26051,2018,9901,9341,560,5.7
26053,2018,6190,5876,314,5.1
26055,2018,49149,47325,1824,3.7
26057,2018,17784,16955,829,4.7
26059,2018,20557,19727,830,4
26061,2018,16148,15322,826,5.1
26063,2018,15440,14722,718,4.7
26065,2018,151099,145594,5505,3.6
26067,2018,29902,28868,1034,3.5
26069,2018,10065,9423,642,6.4
26071,2018,5131,4844,287,5.6
26073,2018,34841,33489,1352,3.9
26075,2018,74437,71501,2936,3.9
26077,2018,133577,128995,4582,3.4
26079,2018,7825,7364,461,5.9
26081,2018,359567,348807,10760,3
26083,2018,881,819,62,7
26085,2018,3631,3383,248,6.8
26087,2018,40985,38861,2124,5.2
26089,2018,10410,9965,445,4.3
26091,2018,46807,44895,1912,4.1
26093,2018,103175,99794,3381,3.3
26095,2018,2377,2228,149,6.3
26097,2018,5194,4701,493,9.5
26099,2018,445932,427957,17975,4
26101,2018,10335,9734,601,5.8
26103,2018,32472,30880,1592,4.9
26105,2018,13765,13091,674,4.9
26107,2018,18462,17537,925,5
26109,2018,10983,10539,444,4
26111,2018,40652,39033,1619,4
26113,2018,6868,6516,352,5.1
26115,2018,75898,72709,3189,4.2
26117,2018,28307,27099,1208,4.3
26119,2018,3014,2750,264,8.800000000000001
26121,2018,77959,74390,3569,4.6
26123,2018,23168,22152,1016,4.4
26125,2018,673420,650941,22479,3.3
26127,2018,12021,11271,750,6.2
26129,2018,8201,7633,568,6.9
26131,2018,2095,1931,164,7.8
26133,2018,10882,10398,484,4.4
26135,2018,2947,2757,190,6.4
26137,2018,11589,10978,611,5.3
26139,2018,160745,156190,4555,2.8
26141,2018,5036,4633,403,8
26143,2018,7844,7232,612,7.8
26145,2018,87068,82926,4142,4.8
26147,2018,75419,71837,3582,4.7
26149,2018,28289,27232,1057,3.7
26151,2018,19209,18216,993,5.2
26153,2018,3364,3123,241,7.2
26155,2018,33231,31798,1433,4.3
26157,2018,23758,22457,1301,5.5
26159,2018,35067,33345,1722,4.9
26161,2018,195926,189923,6003,3.1
26163,2018,797770,756452,41318,5.2
26165,2018,14710,14019,691,4.7
27001,2018,7186,6780,406,5.6
27003,2018,196693,191195,5498,2.8
27005,2018,18606,17938,668,3.6
27007,2018,24154,23158,996,4.1
27009,2018,21839,21071,768,3.5
27011,2018,2502,2406,96,3.8
27013,2018,40304,39284,1020,2.5
27015,2018,14477,13986,491,3.4
27017,2018,17828,17091,737,4.1
27019,2018,58287,56844,1443,2.5
27021,2018,14285,13544,741,5.2
27023,2018,6880,6659,221,3.2
27025,2018,29794,28786,1008,3.4
27027,2018,35653,34622,1031,2.9
27029,2018,4466,4100,366,8.199999999999999
27031,2018,3046,2940,106,3.5
27033,2018,5804,5596,208,3.6
27035,2018,32167,30886,1281,4
27037,2018,240364,234205,6159,2.6
27039,2018,11771,11414,357,3
27041,2018,20605,20018,587,2.8
27043,2018,6989,6746,243,3.5
27045,2018,11480,11120,360,3.1
27047,2018,16023,15508,515,3.2
27049,2018,26781,26038,743,2.8
27051,2018,3298,3165,133,4
27053,2018,702946,685282,17664,2.5
27055,2018,10393,10093,300,2.9
27057,2018,9875,9379,496,5
27059,2018,21201,20406,795,3.7
27061,2018,21784,20599,1185,5.4
27063,2018,5713,5545,168,2.9
27065,2018,8943,8449,494,5.5
27067,2018,24730,23996,734,3
27069,2018,2334,2266,68,2.9
27071,2018,5937,5572,365,6.1
27073,2018,3520,3391,129,3.7
27075,2018,5477,5303,174,3.2
27077,2018,2399,2307,92,3.8
27079,2018,16074,15404,670,4.2
27081,2018,3260,3161,99,3
27083,2018,14757,14333,424,2.9
27085,2018,19521,18905,616,3.2
27087,2018,2323,2215,108,4.6
27089,2018,5418,5101,317,5.9
27091,2018,10260,9935,325,3.2
27093,2018,13159,12697,462,3.5
27095,2018,12837,12212,625,4.9
27097,2018,17542,16711,831,4.7
27099,2018,20385,19829,556,2.7
27101,2018,4879,4695,184,3.8
27103,2018,20785,20322,463,2.2
27105,2018,11291,10994,297,2.6
27107,2018,3357,3211,146,4.3
27109,2018,87755,85721,2034,2.3
27111,2018,31356,30216,1140,3.6
27113,2018,8765,8397,368,4.2
27115,2018,14868,14139,729,4.9
27117,2018,4931,4787,144,2.9
27119,2018,16696,16076,620,3.7
27121,2018,6411,6242,169,2.6
27123,2018,288134,280330,7804,2.7
27125,2018,2226,2111,115,5.2
27127,2018,7610,7335,275,3.6
27129,2018,8714,8367,347,4
27131,2018,36904,35874,1030,2.8
27133,2018,5696,5564,132,2.3
27135,2018,7889,7623,266,3.4
27137,2018,101903,98115,3788,3.7
27139,2018,83167,81074,2093,2.5
27141,2018,52162,50506,1656,3.2
27143,2018,8508,8237,271,3.2
27145,2018,90056,87384,2672,3
27147,2018,20465,19854,611,3
27149,2018,5444,5314,130,2.4
27151,2018,5015,4830,185,3.7
27153,2018,13478,12948,530,3.9
27155,2018,1776,1718,58,3.3
27157,2018,12213,11848,365,3
27159,2018,5907,5597,310,5.2
27161,2018,8974,8606,368,4.1
27163,2018,142624,139023,3601,2.5
27165,2018,6521,6294,227,3.5
27167,2018,3521,3415,106,3
27169,2018,28698,27941,757,2.6
27171,2018,75330,73073,2257,3
27173,2018,5346,5185,161,3
28001,2018,11224,10511,713,6.4
28003,2018,16103,15431,672,4.2
28005,2018,4382,4110,272,6.2
28007,2018,6955,6561,394,5.7
28009,2018,3028,2857,171,5.6
28011,2018,12389,11628,761,6.1
28013,2018,5558,5297,261,4.7
28015,2018,3445,3249,196,5.7
28017,2018,7006,6653,353,5
28019,2018,3709,3526,183,4.9
28021,2018,3013,2735,278,9.199999999999999
28023,2018,5947,5614,333,5.6
28025,2018,7688,7218,470,6.1
28027,2018,8379,7786,593,7.1
28029,2018,11133,10508,625,5.6
28031,2018,8072,7709,363,4.5
28033,2018,90547,87088,3459,3.8
28035,2018,33104,31614,1490,4.5
28037,2018,2806,2639,167,6
28039,2018,8782,8206,576,6.6
28041,2018,4286,4015,271,6.3
28043,2018,9556,9144,412,4.3
28045,2018,18654,17699,955,5.1
28047,2018,85854,81863,3991,4.6
28049,2018,106905,101839,5066,4.7
28051,2018,5685,5173,512,9
28053,2018,2193,1998,195,8.9
28055,2018,369,336,33,8.9
28057,2018,10378,9955,423,4.1
28059,2018,58245,54937,3308,5.7
28061,2018,5990,5633,357,6
28063,2018,2021,1754,267,13.2
28065,2018,4096,3821,275,6.7
28067,2018,25564,24309,1255,4.9
28069,2018,3566,3299,267,7.5
28071,2018,28116,27007,1109,3.9
28073,2018,30610,29477,1133,3.7
28075,2018,30752,29209,1543,5
28077,2018,4638,4362,276,6
28079,2018,7832,7436,396,5.1
28081,2018,40718,39130,1588,3.9
28083,2018,9945,9250,695,7
28085,2018,14584,13892,692,4.7
28087,2018,25142,23912,1230,4.9
28089,2018,53151,51163,1988,3.7
28091,2018,10023,9503,520,5.2
28093,2018,14350,13626,724,5
28095,2018,15416,14658,758,4.9
28097,2018,4001,3787,214,5.3
28099,2018,10158,9645,513,5.1
28101,2018,8764,8342,422,4.8
28103,2018,3803,3545,258,6.8
28105,2018,22346,21282,1064,4.8
28107,2018,12826,12043,783,6.1
28109,2018,23505,22382,1123,4.8
28111,2018,4259,4006,253,5.9
28113,2018,14454,13608,846,5.9
28115,2018,14603,14036,567,3.9
28117,2018,11235,10747,488,4.3
28119,2018,2356,2173,183,7.8
28121,2018,76098,73449,2649,3.5
28123,2018,12913,12398,515,4
28125,2018,1605,1487,118,7.4
28127,2018,10726,10230,496,4.6
28129,2018,6750,6450,300,4.4
28131,2018,6712,6320,392,5.8
28133,2018,7774,7160,614,7.9
28135,2018,5262,4978,284,5.4
28137,2018,12259,11646,613,5
28139,2018,9438,9026,412,4.4
28141,2018,8497,8106,391,4.6
28143,2018,4395,4156,239,5.4
28145,2018,14018,13520,498,3.6
28147,2018,5048,4722,326,6.5
28149,2018,20454,19336,1118,5.5
28151,2018,17231,16056,1175,6.8
28153,2018,7314,6911,403,5.5
28155,2018,3898,3704,194,5
28157,2018,2773,2533,240,8.699999999999999
28159,2018,7292,6874,418,5.7
28161,2018,5109,4856,253,5
28163,2018,9357,8831,526,5.6
29001,2018,10631,10259,372,3.5
29003,2018,9725,9472,253,2.6
29005,2018,2768,2700,68,2.5
29007,2018,10798,10469,329,3
29009,2018,15624,15167,457,2.9
29011,2018,5183,5025,158,3
29013,2018,7861,7561,300,3.8
29015,2018,7170,6850,320,4.5
29017,2018,5434,5240,194,3.6
29019,2018,97667,95474,2193,2.2
29021,2018,44392,43091,1301,2.9
29023,2018,18123,17305,818,4.5
29025,2018,4357,4221,136,3.1
29027,2018,21145,20538,607,2.9
29029,2018,18605,17828,777,4.2
29031,2018,40276,39183,1093,2.7
29033,2018,4667,4522,145,3.1
29035,2018,2507,2382,125,5
29037,2018,54304,52656,1648,3
29039,2018,5703,5510,193,3.4
29041,2018,3767,3663,104,2.8
29043,2018,44076,42953,1123,2.5
29045,2018,3205,3083,122,3.8
29047,2018,134988,131103,3885,2.9
29049,2018,10673,10335,338,3.2
29051,2018,38512,37566,946,2.5
29053,2018,7425,7198,227,3.1
29055,2018,10849,10432,417,3.8
29057,2018,3569,3474,95,2.7
29059,2018,6955,6684,271,3.9
29061,2018,4038,3918,120,3
29063,2018,4852,4702,150,3.1
29065,2018,6213,6011,202,3.3
29067,2018,5066,4842,224,4.4
29069,2018,12031,11379,652,5.4
29071,2018,52594,51005,1589,3
29073,2018,7746,7524,222,2.9
29075,2018,3577,3492,85,2.4
29077,2018,148451,144698,3753,2.5
29079,2018,4544,4383,161,3.5
29081,2018,3846,3730,116,3
29083,2018,9794,9450,344,3.5
29085,2018,3843,3687,156,4.1
29087,2018,2650,2588,62,2.3
29089,2018,4972,4834,138,2.8
29091,2018,16274,15704,570,3.5
29093,2018,3537,3349,188,5.3
29095,2018,359032,345609,13423,3.7
29097,2018,56539,54995,1544,2.7
29099,2018,116778,113195,3583,3.1
29101,2018,22772,21941,831,3.6
29103,2018,1918,1864,54,2.8
29105,2018,16792,16179,613,3.7
29107,2018,16757,16219,538,3.2
29109,2018,18090,17545,545,3
29111,2018,5077,4935,142,2.8
29113,2018,28157,27255,902,3.2
29115,2018,5127,4890,237,4.6
29117,2018,7508,7324,184,2.5
29119,2018,10460,10143,317,3
29121,2018,7618,7395,223,2.9
29123,2018,5463,5273,190,3.5
29125,2018,3878,3752,126,3.2
29127,2018,14451,14010,441,3.1
29129,2018,1908,1850,58,3
29131,2018,12132,11696,436,3.6
29133,2018,5944,5721,223,3.8
29135,2018,7290,7076,214,2.9
29137,2018,3962,3823,139,3.5
29139,2018,5695,5532,163,2.9
29141,2018,7972,7637,335,4.2
29143,2018,8036,7660,376,4.7
29145,2018,27087,26277,810,3
29147,2018,10660,10354,306,2.9
29149,2018,3945,3810,135,3.4
29151,2018,7062,6895,167,2.4
29153,2018,3446,3271,175,5.1
29155,2018,6319,5978,341,5.4
29157,2018,10183,9949,234,2.3
29159,2018,20764,19916,848,4.1
29161,2018,19687,19089,598,3
29163,2018,7682,7407,275,3.6
29165,2018,58039,56565,1474,2.5
29167,2018,14412,13893,519,3.6
29169,2018,14619,14099,520,3.6
29171,2018,2424,2341,83,3.4
29173,2018,5619,5463,156,2.8
29175,2018,10244,9858,386,3.8
29177,2018,10917,10525,392,3.6
29179,2018,3036,2942,94,3.1
29181,2018,5100,4837,263,5.2
29183,2018,224590,219001,5589,2.5
29185,2018,3794,3631,163,4.3
29186,2018,9207,8952,255,2.8
29187,2018,26531,25577,954,3.6
29189,2018,526570,511002,15568,3
29195,2018,10734,10408,326,3
29197,2018,2012,1931,81,4
29199,2018,2393,2326,67,2.8
29201,2018,20058,19383,675,3.4
29203,2018,3240,3081,159,4.9
29205,2018,3025,2933,92,3
29207,2018,13094,12522,572,4.4
29209,2018,13732,13096,636,4.6
29211,2018,2799,2712,87,3.1
29213,2018,26951,25569,1382,5.1
29215,2018,9034,8672,362,4
29217,2018,9574,9277,297,3.1
29219,2018,17779,17288,491,2.8
29221,2018,10214,9766,448,4.4
29223,2018,5341,5088,253,4.7
29225,2018,16987,16467,520,3.1
29227,2018,1193,1159,34,2.8
29229,2018,7427,7123,304,4.1
29510,2018,151245,145477,5768,3.8
30001,2018,5033,4880,153,3
30003,2018,5091,4611,480,9.4
30005,2018,2292,2197,95,4.1
30007,2018,2622,2520,102,3.9
30009,2018,5471,5282,189,3.5
30011,2018,666,649,17,2.6
30013,2018,37781,36453,1328,3.5
30015,2018,2472,2399,73,3
30017,2018,6067,5884,183,3
30019,2018,882,864,18,2
30021,2018,4627,4506,121,2.6
30023,2018,5124,4945,179,3.5
30025,2018,1694,1664,30,1.8
30027,2018,5804,5596,208,3.6
30029,2018,47769,45514,2255,4.7
30031,2018,66809,65149,1660,2.5
30033,2018,736,716,20,2.7
30035,2018,5700,5264,436,7.6
30037,2018,369,352,17,4.6
30039,2018,1692,1604,88,5.2
30041,2018,7669,7404,265,3.5
30043,2018,5637,5426,211,3.7
30045,2018,911,881,30,3.3
30047,2018,13111,12562,549,4.2
30049,2018,35378,34223,1155,3.3
30051,2018,960,936,24,2.5
30053,2018,8062,7477,585,7.3
30055,2018,967,949,18,1.9
30057,2018,4573,4412,161,3.5
30059,2018,956,920,36,3.8
30061,2018,1717,1596,121,7
30063,2018,63147,61087,2060,3.3
30065,2018,2279,2185,94,4.1
30067,2018,8836,8504,332,3.8
30069,2018,281,270,11,3.9
30071,2018,1901,1817,84,4.4
30073,2018,2714,2607,107,3.9
30075,2018,967,940,27,2.8
30077,2018,2914,2796,118,4
30079,2018,487,469,18,3.7
30081,2018,19929,19110,819,4.1
30083,2018,5872,5698,174,3
30085,2018,4466,4267,199,4.5
30087,2018,3860,3662,198,5.1
30089,2018,4775,4476,299,6.3
30091,2018,1757,1717,40,2.3
30093,2018,17223,16548,675,3.9
30095,2018,4938,4773,165,3.3
30097,2018,1774,1721,53,3
30099,2018,2696,2607,89,3.3
30101,2018,2128,2075,53,2.5
30103,2018,333,324,9,2.7
30105,2018,4119,3996,123,3
30107,2018,800,761,39,4.9
30109,2018,465,449,16,3.4
30111,2018,81536,78878,2658,3.3
31001,2018,16564,16069,495,3
31003,2018,3568,3479,89,2.5
31005,2018,221,210,11,5
31007,2018,379,365,14,3.7
31009,2018,261,249,12,4.6
31011,2018,2911,2844,67,2.3
31013,2018,5401,5245,156,2.9
31015,2018,1076,1043,33,3.1
31017,2018,1389,1341,48,3.5
31019,2018,27717,27041,676,2.4
31021,2018,3463,3343,120,3.5
31023,2018,4546,4436,110,2.4
31025,2018,13325,12911,414,3.1
31027,2018,4470,4363,107,2.4
31029,2018,2275,2224,51,2.2
31031,2018,3334,3259,75,2.2
31033,2018,4696,4561,135,2.9
31035,2018,3249,3144,105,3.2
31037,2018,5588,5449,139,2.5
31039,2018,4689,4568,121,2.6
31041,2018,6418,6277,141,2.2
31043,2018,10676,10285,391,3.7
31045,2018,5019,4882,137,2.7
31047,2018,12934,12562,372,2.9
31049,2018,960,931,29,3
31051,2018,3011,2916,95,3.2
31053,2018,19402,18845,557,2.9
31055,2018,294689,285210,9479,3.2
31057,2018,1150,1124,26,2.3
31059,2018,3144,3063,81,2.6
31061,2018,1473,1427,46,3.1
31063,2018,1514,1474,40,2.6
31065,2018,2624,2554,70,2.7
31067,2018,10934,10576,358,3.3
31069,2018,1182,1153,29,2.5
31071,2018,1163,1134,29,2.5
31073,2018,1058,1030,28,2.6
31075,2018,419,408,11,2.6
31077,2018,1212,1179,33,2.7
31079,2018,31872,30827,1045,3.3
31081,2018,4744,4622,122,2.6
31083,2018,1771,1728,43,2.4
31085,2018,598,585,13,2.2
31087,2018,1255,1211,44,3.5
31089,2018,5742,5591,151,2.6
31091,2018,401,386,15,3.7
31093,2018,3352,3247,105,3.1
31095,2018,4152,4046,106,2.6
31097,2018,2074,1998,76,3.7
31099,2018,3755,3675,80,2.1
31101,2018,4546,4405,141,3.1
31103,2018,593,580,13,2.2
31105,2018,2019,1963,56,2.8
31107,2018,4631,4484,147,3.2
31109,2018,174726,170079,4647,2.7
31111,2018,18296,17729,567,3.1
31113,2018,466,452,14,3
31115,2018,398,385,13,3.3
31117,2018,442,430,12,2.7
31119,2018,19463,18956,507,2.6
31121,2018,3999,3883,116,2.9
31123,2018,2583,2511,72,2.8
31125,2018,2010,1960,50,2.5
31127,2018,3610,3482,128,3.5
31129,2018,2378,2312,66,2.8
31131,2018,8159,7918,241,3
31133,2018,1472,1434,38,2.6
31135,2018,1817,1781,36,2
31137,2018,4885,4771,114,2.3
31139,2018,4097,3986,111,2.7
31141,2018,17409,16928,481,2.8
31143,2018,2894,2823,71,2.5
31145,2018,5831,5688,143,2.5
31147,2018,4237,4105,132,3.1
31149,2018,887,865,22,2.5
31151,2018,7427,7196,231,3.1
31153,2018,94964,92307,2657,2.8
31155,2018,11005,10690,315,2.9
31157,2018,18394,17777,617,3.4
31159,2018,8797,8561,236,2.7
31161,2018,2677,2607,70,2.6
31163,2018,1693,1647,46,2.7
31165,2018,741,721,20,2.7
31167,2018,3480,3391,89,2.6
31169,2018,2852,2786,66,2.3
31171,2018,436,423,13,3
31173,2018,2975,2850,125,4.2
31175,2018,2080,2018,62,3
31177,2018,11103,10779,324,2.9
31179,2018,5687,5543,144,2.5
31181,2018,1645,1597,48,2.9
31183,2018,573,559,14,2.4
31185,2018,7301,7112,189,2.6
32001,2018,11021,10598,423,3.8
32003,2018,1101978,1050577,51401,4.7
32005,2018,22912,21943,969,4.2
32007,2018,27453,26595,858,3.1
32009,2018,424,403,21,5
32011,2018,1094,1066,28,2.6
32013,2018,8061,7791,270,3.3
32015,2018,3143,3032,111,3.5
32017,2018,2064,1974,90,4.4
32019,2018,22334,21138,1196,5.4
32021,2018,1971,1869,102,5.2
32023,2018,16705,15764,941,5.6
32027,2018,2579,2475,104,4
32029,2018,1991,1905,86,4.3
32031,2018,249680,240837,8843,3.5
32033,2018,4578,4414,164,3.6
32510,2018,25697,24511,1186,4.6
33001,2018,31262,30462,800,2.6
33003,2018,23702,23092,610,2.6
33005,2018,40727,39680,1047,2.6
33007,2018,14587,14115,472,3.2
33009,2018,49363,48318,1045,2.1
33011,2018,238088,231744,6344,2.7
33013,2018,82970,81104,1866,2.2
33015,2018,185339,180155,5184,2.8
33017,2018,73561,71853,1708,2.3
33019,2018,23159,22661,498,2.2
34001,2018,118818,111885,6933,5.8
34003,2018,474700,458630,16070,3.4
34005,2018,227612,219125,8487,3.7
34007,2018,250133,238635,11498,4.6
34009,2018,45497,41687,3810,8.4
34011,2018,64566,60438,4128,6.4
34013,2018,365106,346431,18675,5.1
34015,2018,147928,141729,6199,4.2
34017,2018,356064,342400,13664,3.8
34019,2018,63651,61614,2037,3.2
34021,2018,198876,191729,7147,3.6
34023,2018,432712,417089,15623,3.6
34025,2018,323777,312005,11772,3.6
34027,2018,253482,245258,8224,3.2
34029,2018,271226,259747,11479,4.2
34031,2018,239176,227105,12071,5
34033,2018,28756,27198,1558,5.4
34035,2018,169154,163400,5754,3.4
34037,2018,73026,70178,2848,3.9
34039,2018,273348,261705,11643,4.3
34041,2018,54912,52807,2105,3.8
35001,2018,328200,313554,14646,4.5
35003,2018,1113,1043,70,6.3
35005,2018,27056,25756,1300,4.8
35006,2018,8897,8348,549,6.2
35007,2018,5481,5216,265,4.8
35009,2018,21532,20677,855,4
35011,2018,763,729,34,4.5
35013,2018,96182,90766,5416,5.6
35015,2018,31457,30421,1036,3.3
35017,2018,12254,11668,586,4.8
35019,2018,1616,1528,88,5.4
35021,2018,277,263,14,5.1
35023,2018,2203,2121,82,3.7
35025,2018,29889,28664,1225,4.1
35027,2018,8687,8296,391,4.5
35028,2018,9076,8770,306,3.4
35029,2018,10104,8919,1185,11.7
35031,2018,23738,22071,1667,7
35033,2018,2269,2132,137,6
35035,2018,24600,23403,1197,4.9
35037,2018,3201,3049,152,4.7
35039,2018,16562,15709,853,5.2
35041,2018,7798,7464,334,4.3
35043,2018,65383,62184,3199,4.9
35045,2018,52077,49105,2972,5.7
35047,2018,10879,10241,638,5.9
35049,2018,73904,70875,3029,4.1
35051,2018,4078,3796,282,6.9
35053,2018,6423,6088,335,5.2
35055,2018,14951,13988,963,6.4
35057,2018,5591,5169,422,7.5
35059,2018,1776,1718,58,3.3
35061,2018,30232,28604,1628,5.4
36001,2018,157520,151688,5832,3.7
36003,2018,19481,18390,1091,5.6
36005,2018,599929,565365,34564,5.8
36007,2018,84140,80039,4101,4.9
36009,2018,34042,32225,1817,5.3
36011,2018,35977,34370,1607,4.5
36013,2018,54779,52019,2760,5
36015,2018,35353,33718,1635,4.6
36017,2018,22327,21285,1042,4.7
36019,2018,36267,34677,1590,4.4
36021,2018,31255,30215,1040,3.3
36023,2018,22856,21690,1166,5.1
36025,2018,19078,18153,925,4.8
36027,2018,143632,138335,5297,3.7
36029,2018,442142,422609,19533,4.4
36031,2018,17048,16222,826,4.8
36033,2018,19600,18591,1009,5.1
36035,2018,22812,21647,1165,5.1
36037,2018,29731,28491,1240,4.2
36039,2018,20616,19675,941,4.6
36041,2018,2289,2132,157,6.9
36043,2018,27796,26427,1369,4.9
36045,2018,44493,42010,2483,5.6
36047,2018,1201389,1149779,51610,4.3
36049,2018,11623,10976,647,5.6
36051,2018,30690,29363,1327,4.3
36053,2018,32660,31097,1563,4.8
36055,2018,361972,346548,15424,4.3
36057,2018,22426,21268,1158,5.2
36059,2018,706551,681686,24865,3.5
36061,2018,914163,880074,34089,3.7
36063,2018,99042,93855,5187,5.2
36065,2018,100914,96422,4492,4.5
36067,2018,219814,211006,8808,4
36069,2018,55381,53202,2179,3.9
36071,2018,183560,176409,7151,3.9
36073,2018,17534,16666,868,5
36075,2018,52741,49855,2886,5.5
36077,2018,28037,26815,1222,4.4
36079,2018,51073,49190,1883,3.7
36081,2018,1141830,1100018,41812,3.7
36083,2018,81191,78026,3165,3.9
36085,2018,222771,213493,9278,4.2
36087,2018,154449,148705,5744,3.7
36089,2018,43382,40950,2432,5.6
36091,2018,119110,114911,4199,3.5
36093,2018,76165,73107,3058,4
36095,2018,14624,13917,707,4.8
36097,2018,8226,7804,422,5.1
36099,2018,16092,15471,621,3.9
36101,2018,42613,40507,2106,4.9
36103,2018,776558,746685,29873,3.8
36105,2018,35927,34454,1473,4.1
36107,2018,22868,21869,999,4.4
36109,2018,50016,48205,1811,3.6
36111,2018,88268,84817,3451,3.9
36113,2018,31528,30059,1469,4.7
36115,2018,27938,26774,1164,4.2
36117,2018,43774,41958,1816,4.1
36119,2018,482058,463315,18743,3.9
36121,2018,17969,17135,834,4.6
36123,2018,11784,11339,445,3.8
37001,2018,80858,77779,3079,3.8
37003,2018,17946,17370,576,3.2
37005,2018,4314,4117,197,4.6
37007,2018,10418,9950,468,4.5
37009,2018,12701,12239,462,3.6
37011,2018,7598,7318,280,3.7
37013,2018,19681,18768,913,4.6
37015,2018,7837,7447,390,5
37017,2018,14379,13613,766,5.3
37019,2018,53185,50347,2838,5.3
37021,2018,138995,134810,4185,3
37023,2018,40838,39348,1490,3.6
37025,2018,107083,103182,3901,3.6
37027,2018,36395,34981,1414,3.9
37029,2018,4706,4529,177,3.8
37031,2018,31892,30498,1394,4.4
37033,2018,9828,9392,436,4.4
37035,2018,78670,75869,2801,3.6
37037,2018,35108,33913,1195,3.4
37039,2018,11268,10762,506,4.5
37041,2018,5584,5334,250,4.5
37043,2018,4124,3943,181,4.4
37045,2018,47897,45986,1911,4
37047,2018,22371,21245,1126,5
37049,2018,41529,39757,1772,4.3
37051,2018,127620,120964,6656,5.2
37053,2018,13997,13493,504,3.6
37055,2018,19965,18934,1031,5.2
37057,2018,80401,77434,2967,3.7
37059,2018,20541,19829,712,3.5
37061,2018,25041,23955,1086,4.3
37063,2018,168760,162760,6000,3.6
37065,2018,21498,20015,1483,6.9
37067,2018,186902,179681,7221,3.9
37069,2018,30761,29510,1251,4.1
37071,2018,109078,104754,4324,4
37073,2018,5318,5103,215,4
37075,2018,3182,2995,187,5.9
37077,2018,29971,28941,1030,3.4
37079,2018,9533,9163,370,3.9
37081,2018,262078,251040,11038,4.2
37083,2018,20183,18949,1234,6.1
37085,2018,52879,50382,2497,4.7
37087,2018,29653,28640,1013,3.4
37089,2018,54525,52734,1791,3.3
37091,2018,9127,8664,463,5.1
37093,2018,20109,19088,1021,5.1
37095,2018,2016,1849,167,8.300000000000001
37097,2018,87854,84645,3209,3.7
37099,2018,19553,18728,825,4.2
37101,2018,97395,93823,3572,3.7
37103,2018,4382,4196,186,4.2
37105,2018,26506,25339,1167,4.4
37107,2018,27871,26768,1103,4
37109,2018,42638,41153,1485,3.5
37111,2018,21117,20395,722,3.4
37113,2018,15356,14748,608,4
37115,2018,10071,9701,370,3.7
37117,2018,9288,8822,466,5
37119,2018,611032,587780,23252,3.8
37121,2018,6027,5755,272,4.5
37123,2018,11533,11068,465,4
37125,2018,41079,39495,1584,3.9
37127,2018,43392,41167,2225,5.1
37129,2018,121248,116583,4665,3.8
37131,2018,7634,7243,391,5.1
37133,2018,64334,61202,3132,4.9
37135,2018,77614,75056,2558,3.3
37137,2018,5324,5102,222,4.2
37139,2018,17019,16201,818,4.8
37141,2018,28260,27071,1189,4.2
37143,2018,5024,4780,244,4.9
37145,2018,18158,17398,760,4.2
37147,2018,89552,85686,3866,4.3
37149,2018,8950,8609,341,3.8
37151,2018,66085,63576,2509,3.8
37153,2018,16547,15637,910,5.5
37155,2018,49714,46772,2942,5.9
37157,2018,40109,38259,1850,4.6
37159,2018,64986,62368,2618,4
37161,2018,24793,23520,1273,5.1
37163,2018,29282,28096,1186,4.1
37165,2018,11476,10629,847,7.4
37167,2018,29866,28785,1081,3.6
37169,2018,21587,20793,794,3.7
37171,2018,34033,32828,1205,3.5
37173,2018,6920,6620,300,4.3
37175,2018,14286,13742,544,3.8
37177,2018,1477,1384,93,6.3
37179,2018,121603,117317,4286,3.5
37181,2018,17418,16400,1018,5.8
37183,2018,585448,565356,20092,3.4
37185,2018,6559,6164,395,6
37187,2018,4619,4342,277,6
37189,2018,28906,27884,1022,3.5
37191,2018,52574,50291,2283,4.3
37193,2018,30152,29009,1143,3.8
37195,2018,35280,33089,2191,6.2
37197,2018,17623,17024,599,3.4
37199,2018,8246,7947,299,3.6
38001,2018,1058,1037,21,2
38003,2018,5211,5072,139,2.7
38005,2018,2290,2202,88,3.8
38007,2018,422,410,12,2.8
38009,2018,2974,2876,98,3.3
38011,2018,1630,1600,30,1.8
38013,2018,1066,1041,25,2.3
38015,2018,49160,47881,1279,2.6
38017,2018,101737,99441,2296,2.3
38019,2018,1963,1912,51,2.6
38021,2018,2385,2342,43,1.8
38023,2018,1520,1500,20,1.3
38025,2018,3031,2982,49,1.6
38027,2018,1234,1174,60,4.9
38029,2018,1473,1403,70,4.8
38031,2018,1584,1543,41,2.6
38033,2018,881,864,17,1.9
38035,2018,37713,36874,839,2.2
38037,2018,1200,1169,31,2.6
38039,2018,1046,1023,23,2.2
38041,2018,1393,1365,28,2
38043,2018,1292,1235,57,4.4
38045,2018,2105,2064,41,1.9
38047,2018,891,869,22,2.5
38049,2018,3102,2981,121,3.9
38051,2018,1138,1108,30,2.6
38053,2018,9021,8869,152,1.7
38055,2018,4726,4571,155,3.3
38057,2018,3920,3756,164,4.2
38059,2018,16244,15723,521,3.2
38061,2018,7042,6932,110,1.6
38063,2018,1403,1357,46,3.3
38065,2018,873,838,35,4
38067,2018,3353,3222,131,3.9
38069,2018,1763,1707,56,3.2
38071,2018,5627,5469,158,2.8
38073,2018,2815,2762,53,1.9
38075,2018,1212,1183,29,2.4
38077,2018,8672,8448,224,2.6
38079,2018,4658,4224,434,9.300000000000001
38081,2018,2537,2490,47,1.9
38083,2018,682,651,31,4.5
38085,2018,1240,1190,50,4
38087,2018,398,389,9,2.3
38089,2018,18171,17737,434,2.4
38091,2018,996,976,20,2
38093,2018,10508,10249,259,2.5
38095,2018,1182,1152,30,2.5
38097,2018,4421,4306,115,2.6
38099,2018,5263,5100,163,3.1
38101,2018,31739,30842,897,2.8
38103,2018,1977,1917,60,3
38105,2018,23641,23171,470,2
39001,2018,10895,10130,765,7
39003,2018,47888,45754,2134,4.5
39005,2018,26170,24979,1191,4.6
39007,2018,44406,42086,2320,5.2
39009,2018,27855,26283,1572,5.6
39011,2018,24634,23828,806,3.3
39013,2018,30533,28868,1665,5.5
39015,2018,19445,18403,1042,5.4
39017,2018,193545,185551,7994,4.1
39019,2018,12972,12287,685,5.3
39021,2018,19901,19144,757,3.8
39023,2018,63076,60202,2874,4.6
39025,2018,105988,101651,4337,4.1
39027,2018,17549,16630,919,5.2
39029,2018,47234,44808,2426,5.1
39031,2018,14405,13519,886,6.2
39033,2018,18021,17078,943,5.2
39035,2018,616198,586824,29374,4.8
39037,2018,25854,24852,1002,3.9
39039,2018,18197,17397,800,4.4
39041,2018,109007,105317,3690,3.4
39043,2018,37896,35788,2108,5.6
39045,2018,77150,74020,3130,4.1
39047,2018,14092,13513,579,4.1
39049,2018,689443,663145,26298,3.8
39051,2018,22320,21342,978,4.4
39053,2018,12289,11550,739,6
39055,2018,49369,47425,1944,3.9
39057,2018,82701,79369,3332,4
39059,2018,18750,17721,1029,5.5
39061,2018,412629,395700,16929,4.1
39063,2018,41351,39942,1409,3.4
39065,2018,14016,13405,611,4.4
39067,2018,6926,6565,361,5.2
39069,2018,13297,12644,653,4.9
39071,2018,17138,16194,944,5.5
39073,2018,12959,12301,658,5.1
39075,2018,20652,19979,673,3.3
39077,2018,27954,26316,1638,5.9
39079,2018,12788,11957,831,6.5
39081,2018,27674,25940,1734,6.3
39083,2018,31379,30020,1359,4.3
39085,2018,127039,121618,5421,4.3
39087,2018,23797,22471,1326,5.6
39089,2018,89426,85887,3539,4
39091,2018,23127,22270,857,3.7
39093,2018,154668,147076,7592,4.9
39095,2018,209633,198680,10953,5.2
39097,2018,20585,19803,782,3.8
39099,2018,104224,98091,6133,5.9
39101,2018,28471,27215,1256,4.4
39103,2018,97984,94194,3790,3.9
39105,2018,8964,8319,645,7.2
39107,2018,23625,22978,647,2.7
39109,2018,53726,51632,2094,3.9
39111,2018,5188,4787,401,7.7
39113,2018,250991,239637,11354,4.5
39115,2018,6710,6310,400,6
39117,2018,16655,15889,766,4.6
39119,2018,39544,37457,2087,5.3
39121,2018,4767,4451,316,6.6
39123,2018,21096,19773,1323,6.3
39125,2018,8751,8396,355,4.1
39127,2018,15752,14868,884,5.6
39129,2018,26160,25036,1124,4.3
39131,2018,10867,10163,704,6.5
39133,2018,86946,82995,3951,4.5
39135,2018,21164,20306,858,4.1
39137,2018,18662,18039,623,3.3
39139,2018,52829,50245,2584,4.9
39141,2018,34790,33220,1570,4.5
39143,2018,30877,29484,1393,4.5
39145,2018,28968,27024,1944,6.7
39147,2018,27211,26015,1196,4.4
39149,2018,23977,23078,899,3.7
39151,2018,186047,176955,9092,4.9
39153,2018,271361,258743,12618,4.6
39155,2018,87625,82192,5433,6.2
39157,2018,44557,42533,2024,4.5
39159,2018,28630,27638,992,3.5
39161,2018,14406,13901,505,3.5
39163,2018,5497,5158,339,6.2
39165,2018,118208,113665,4543,3.8
39167,2018,27154,25634,1520,5.6
39169,2018,61098,58905,2193,3.6
39171,2018,18950,18264,686,3.6
39173,2018,70786,67961,2825,4
39175,2018,12711,12304,407,3.2
40001,2018,8177,7834,343,4.2
40003,2018,2899,2836,63,2.2
40005,2018,5071,4860,211,4.2
40007,2018,3017,2956,61,2
40009,2018,11419,11121,298,2.6
40011,2018,4482,4391,91,2
40013,2018,20963,20293,670,3.2
40015,2018,12126,11689,437,3.6
40017,2018,73548,71503,2045,2.8
40019,2018,22143,21359,784,3.5
40021,2018,18824,18025,799,4.2
40023,2018,5695,5409,286,5
40025,2018,1377,1351,26,1.9
40027,2018,141611,137478,4133,2.9
40029,2018,2294,2208,86,3.7
40031,2018,48360,46458,1902,3.9
40033,2018,2736,2650,86,3.1
40035,2018,6094,5882,212,3.5
40037,2018,31494,30285,1209,3.8
40039,2018,15675,15291,384,2.4
40041,2018,17967,17256,711,4
40043,2018,2769,2716,53,1.9
40045,2018,2200,2152,48,2.2
40047,2018,27229,26396,833,3.1
40049,2018,12680,12262,418,3.3
40051,2018,26309,25497,812,3.1
40053,2018,2737,2680,57,2.1
40055,2018,1966,1886,80,4.1
40057,2018,1207,1172,35,2.9
40059,2018,1794,1753,41,2.3
40061,2018,4220,4004,216,5.1
40063,2018,5359,5134,225,4.2
40065,2018,10755,10428,327,3
40067,2018,2586,2498,88,3.4
40069,2018,5199,5045,154,3
40071,2018,18932,18044,888,4.7
40073,2018,8927,8736,191,2.1
40075,2018,3527,3380,147,4.2
40077,2018,3218,3025,193,6
40079,2018,19195,18305,890,4.6
40081,2018,15696,15134,562,3.6
40083,2018,21963,21289,674,3.1
40085,2018,6433,6294,139,2.2
40087,2018,19540,18995,545,2.8
40089,2018,14155,13376,779,5.5
40091,2018,6866,6460,406,5.9
40093,2018,4011,3925,86,2.1
40095,2018,6752,6495,257,3.8
40097,2018,19830,19160,670,3.4
40099,2018,6486,6296,190,2.9
40101,2018,29239,28058,1181,4
40103,2018,5728,5579,149,2.6
40105,2018,4624,4429,195,4.2
40107,2018,4504,4290,214,4.8
40109,2018,382074,369308,12766,3.3
40111,2018,15643,14866,777,5
40113,2018,20702,19806,896,4.3
40115,2018,14373,13873,500,3.5
40117,2018,7356,7049,307,4.2
40119,2018,38684,37538,1146,3
40121,2018,17877,17183,694,3.9
40123,2018,18673,18095,578,3.1
40125,2018,32608,31391,1217,3.7
40127,2018,4501,4266,235,5.2
40129,2018,1878,1833,45,2.4
40131,2018,44931,43436,1495,3.3
40133,2018,9505,9053,452,4.8
40135,2018,16358,15648,710,4.3
40137,2018,18537,17802,735,4
40139,2018,9032,8784,248,2.7
40141,2018,3101,2985,116,3.7
40143,2018,322205,311337,10868,3.4
40145,2018,37827,36563,1264,3.3
40147,2018,22944,22043,901,3.9
40149,2018,5277,5116,161,3.1
40151,2018,4646,4546,100,2.2
40153,2018,9273,9018,255,2.7
41001,2018,7127,6751,376,5.3
41003,2018,48224,46727,1497,3.1
41005,2018,218170,210191,7979,3.7
41007,2018,19268,18496,772,4
41009,2018,24327,23120,1207,5
41011,2018,26246,24856,1390,5.3
41013,2018,9510,8953,557,5.9
41015,2018,8953,8420,533,6
41017,2018,95091,91160,3931,4.1
41019,2018,46500,44054,2446,5.3
41021,2018,858,825,33,3.8
41023,2018,3140,2921,219,7
41025,2018,3539,3329,210,5.9
41027,2018,14482,14011,471,3.3
41029,2018,104277,99404,4873,4.7
41031,2018,10180,9635,545,5.4
41033,2018,35632,33693,1939,5.4
41035,2018,29565,27720,1845,6.2
41037,2018,3580,3384,196,5.5
41039,2018,181367,173399,7968,4.4
41041,2018,21063,20056,1007,4.8
41043,2018,58764,56053,2711,4.6
41045,2018,12440,11882,558,4.5
41047,2018,161066,154278,6788,4.2
41049,2018,5738,5496,242,4.2
41051,2018,452492,436194,16298,3.6
41053,2018,39682,37986,1696,4.3
41055,2018,899,863,36,4
41057,2018,11850,11342,508,4.3
41059,2018,36550,34776,1774,4.9
41061,2018,11955,11325,630,5.3
41063,2018,3403,3204,199,5.8
41065,2018,13360,12801,559,4.2
41067,2018,322719,311753,10966,3.4
41069,2018,722,698,24,3.3
41071,2018,54468,52479,1989,3.7
42001,2018,55138,53346,1792,3.3
42003,2018,644152,618427,25725,4
42005,2018,32024,30434,1590,5
42007,2018,83538,79769,3769,4.5
42009,2018,23619,22569,1050,4.4
42011,2018,212675,203905,8770,4.1
42013,2018,59359,56888,2471,4.2
42015,2018,28846,27601,1245,4.3
42017,2018,340387,327738,12649,3.7
42019,2018,99171,95362,3809,3.8
42021,2018,58136,55147,2989,5.1
42023,2018,2133,2028,105,4.9
42025,2018,31673,30089,1584,5
42027,2018,79540,76979,2561,3.2
42029,2018,282564,273694,8870,3.1
42031,2018,17375,16549,826,4.8
42033,2018,35679,33918,1761,4.9
42035,2018,18330,17368,962,5.2
42037,2018,33444,31875,1569,4.7
42039,2018,38846,37049,1797,4.6
42041,2018,130541,126243,4298,3.3
42043,2018,142543,136932,5611,3.9
42045,2018,295691,283945,11746,4
42047,2018,15853,15250,603,3.8
42049,2018,129023,123024,5999,4.6
42051,2018,56742,53459,3283,5.8
42053,2018,1816,1704,112,6.2
42055,2018,76885,74069,2816,3.7
42057,2018,7857,7550,307,3.9
42059,2018,16574,15776,798,4.8
42061,2018,19785,18747,1038,5.2
42063,2018,38719,36836,1883,4.9
42065,2018,20488,19546,942,4.6
42067,2018,12444,11949,495,4
42069,2018,105182,100412,4770,4.5
42071,2018,282029,272566,9463,3.4
42073,2018,40743,38693,2050,5
42075,2018,71369,68707,2662,3.7
42077,2018,190781,182083,8698,4.6
42079,2018,157690,149243,8447,5.4
42081,2018,57246,54534,2712,4.7
42083,2018,17795,16949,846,4.8
42085,2018,49869,47546,2323,4.7
42087,2018,20750,19789,961,4.6
42089,2018,82220,77861,4359,5.3
42091,2018,449999,434669,15330,3.4
42093,2018,9087,8774,313,3.4
42095,2018,159464,152481,6983,4.4
42097,2018,43029,40799,2230,5.2
42099,2018,24210,23314,896,3.7
42101,2018,709058,670112,38946,5.5
42103,2018,25038,23721,1317,5.3
42105,2018,7167,6789,378,5.3
42107,2018,66019,62639,3380,5.1
42109,2018,20285,19489,796,3.9
42111,2018,33494,31804,1690,5
42113,2018,2686,2554,132,4.9
42115,2018,20440,19631,809,4
42117,2018,18814,17853,961,5.1
42119,2018,19588,18861,727,3.7
42121,2018,22402,21315,1087,4.9
42123,2018,19033,18195,838,4.4
42125,2018,106242,101702,4540,4.3
42127,2018,22362,21317,1045,4.7
42129,2018,179859,172002,7857,4.4
42131,2018,13590,12982,608,4.5
42133,2018,234583,225632,8951,3.8
44001,2018,25945,25065,880,3.4
44003,2018,90521,87254,3267,3.6
44005,2018,44169,42630,1539,3.5
44007,2018,324904,310929,13975,4.3
44009,2018,69017,66601,2416,3.5
45001,2018,9974,9574,400,4
45003,2018,74317,71815,2502,3.4
45005,2018,2776,2616,160,5.8
45007,2018,90434,87481,2953,3.3
45009,2018,5031,4702,329,6.5
45011,2018,8344,7944,400,4.8
45013,2018,76206,73726,2480,3.3
45015,2018,101928,98808,3120,3.1
45017,2018,6543,6259,284,4.3
45019,2018,207291,201465,5826,2.8
45021,2018,25154,24234,920,3.7
45023,2018,13144,12496,648,4.9
45025,2018,21960,21243,717,3.3
45027,2018,12611,12016,595,4.7
45029,2018,16776,16099,677,4
45031,2018,30213,28982,1231,4.1
45033,2018,12611,11999,612,4.9
45035,2018,76591,74255,2336,3
45037,2018,10656,10282,374,3.5
45039,2018,9643,9038,605,6.3
45041,2018,66535,64107,2428,3.6
45043,2018,25454,24280,1174,4.6
45045,2018,252563,245134,7429,2.9
45047,2018,31095,29950,1145,3.7
45049,2018,8358,8070,288,3.4
45051,2018,145691,139387,6304,4.3
45053,2018,12415,12040,375,3
45055,2018,28990,27950,1040,3.6
45057,2018,40295,38754,1541,3.8
45059,2018,29947,28868,1079,3.6
45061,2018,6589,6285,304,4.6
45063,2018,148552,144255,4297,2.9
45065,2018,3407,3287,120,3.5
45067,2018,12939,12219,720,5.6
45069,2018,9185,8718,467,5.1
45071,2018,18974,18383,591,3.1
45073,2018,34792,33612,1180,3.4
45075,2018,34456,32452,2004,5.8
45077,2018,56971,55050,1921,3.4
45079,2018,197138,190271,6867,3.5
45081,2018,8795,8518,277,3.1
45083,2018,150134,145417,4717,3.1
45085,2018,43842,42057,1785,4.1
45087,2018,11444,10962,482,4.2
45089,2018,12162,11491,671,5.5
45091,2018,137017,132509,4508,3.3
46003,2018,1561,1515,46,2.9
46005,2018,9562,9305,257,2.7
46007,2018,1079,1030,49,4.5
46009,2018,2872,2797,75,2.6
46011,2018,19050,18496,554,2.9
46013,2018,20858,20261,597,2.9
46015,2018,2507,2439,68,2.7
46017,2018,709,666,43,6.1
46019,2018,5050,4881,169,3.3
46021,2018,786,754,32,4.1
46023,2018,3841,3718,123,3.2
46025,2018,1909,1833,76,4
46027,2018,7258,7046,212,2.9
46029,2018,15363,14894,469,3.1
46031,2018,1390,1333,57,4.1
46033,2018,4006,3841,165,4.1
46035,2018,11043,10751,292,2.6
46037,2018,2786,2665,121,4.3
46039,2018,2167,2070,97,4.5
46041,2018,2226,2029,197,8.800000000000001
46043,2018,1567,1525,42,2.7
46045,2018,2064,2009,55,2.7
46047,2018,3008,2893,115,3.8
46049,2018,1096,1063,33,3
46051,2018,4446,4302,144,3.2
46053,2018,2045,1977,68,3.3
46055,2018,1071,1043,28,2.6
46057,2018,3248,3145,103,3.2
46059,2018,1812,1770,42,2.3
46061,2018,1753,1670,83,4.7
46063,2018,731,713,18,2.5
46065,2018,9897,9641,256,2.6
46067,2018,3577,3478,99,2.8
46069,2018,679,659,20,2.9
46071,2018,1283,1219,64,5
46073,2018,1117,1089,28,2.5
46075,2018,554,539,15,2.7
46077,2018,2660,2583,77,2.9
46079,2018,6649,6420,229,3.4
46081,2018,13074,12686,388,3
46083,2018,33892,33093,799,2.4
46085,2018,1699,1628,71,4.2
46087,2018,3043,2965,78,2.6
46089,2018,1023,983,40,3.9
46091,2018,2426,2332,94,3.9
46093,2018,14021,13549,472,3.4
46095,2018,749,712,37,4.9
46097,2018,1194,1161,33,2.8
46099,2018,110726,107770,2956,2.7
46101,2018,4009,3888,121,3
46102,2018,3582,3207,375,10.5
46103,2018,56148,54395,1753,3.1
46105,2018,1444,1402,42,2.9
46107,2018,1091,1052,39,3.6
46109,2018,4846,4635,211,4.4
46111,2018,1151,1117,34,3
46115,2018,3242,3127,115,3.5
46117,2018,1836,1787,49,2.7
46119,2018,806,785,21,2.6
46121,2018,3144,2946,198,6.3
46123,2018,3105,3026,79,2.5
46125,2018,4655,4526,129,2.8
46127,2018,8408,8140,268,3.2
46129,2018,2216,2106,110,5
46135,2018,11835,11520,315,2.7
46137,2018,924,875,49,5.3
47001,2018,34210,32914,1296,3.8
47003,2018,20755,19971,784,3.8
47005,2018,6892,6553,339,4.9
47007,2018,4229,3977,252,6
47009,2018,62631,60596,2035,3.2
47011,2018,50506,48685,1821,3.6
47013,2018,14655,13951,704,4.8
47015,2018,6422,6218,204,3.2
47017,2018,12034,11437,597,5
47019,2018,23851,22855,996,4.2
47021,2018,21333,20742,591,2.8
47023,2018,8499,8179,320,3.8
47025,2018,12976,12421,555,4.3
47027,2018,2870,2728,142,4.9
47029,2018,14899,14197,702,4.7
47031,2018,24779,23898,881,3.6
47033,2018,6950,6679,271,3.9
47035,2018,23324,22298,1026,4.4
47037,2018,393923,383409,10514,2.7
47039,2018,4496,4268,228,5.1
47041,2018,7754,7404,350,4.5
47043,2018,26321,25518,803,3.1
47045,2018,16187,15441,746,4.6
47047,2018,18980,18268,712,3.8
47049,2018,7193,6893,300,4.2
47051,2018,19860,19185,675,3.4
47053,2018,21843,20883,960,4.4
47055,2018,15282,14721,561,3.7
47057,2018,9370,8996,374,4
47059,2018,29824,28436,1388,4.7
47061,2018,4894,4676,218,4.5
47063,2018,27546,26486,1060,3.8
47065,2018,180867,174706,6161,3.4
47067,2018,2124,2020,104,4.9
47069,2018,9366,8906,460,4.9
47071,2018,10333,9877,456,4.4
47073,2018,23744,22794,950,4
47075,2018,7730,7316,414,5.4
47077,2018,11999,11432,567,4.7
47079,2018,14227,13627,600,4.2
47081,2018,11155,10791,364,3.3
47083,2018,3238,3060,178,5.5
47085,2018,8833,8451,382,4.3
47087,2018,4598,4381,217,4.7
47089,2018,24095,23177,918,3.8
47091,2018,7571,7306,265,3.5
47093,2018,240571,233452,7119,3
47095,2018,1804,1711,93,5.2
47097,2018,9671,9106,565,5.8
47099,2018,18456,17709,747,4
47101,2018,5065,4839,226,4.5
47103,2018,16687,16174,513,3.1
47105,2018,23127,22338,789,3.4
47107,2018,22719,21782,937,4.1
47109,2018,8286,7829,457,5.5
47111,2018,10979,10625,354,3.2
47113,2018,48665,46819,1846,3.8
47115,2018,12322,11742,580,4.7
47117,2018,15449,14911,538,3.5
47119,2018,48178,46613,1565,3.2
47121,2018,5064,4831,233,4.6
47123,2018,19974,19231,743,3.7
47125,2018,84006,80745,3261,3.9
47127,2018,3498,3390,108,3.1
47129,2018,7803,7450,353,4.5
47131,2018,12268,11658,610,5
47133,2018,9793,9422,371,3.8
47135,2018,3250,3109,141,4.3
47137,2018,2437,2343,94,3.9
47139,2018,7300,6990,310,4.2
47141,2018,34419,33182,1237,3.6
47143,2018,13117,12375,742,5.7
47145,2018,23082,22124,958,4.2
47147,2018,37094,35918,1176,3.2
47149,2018,179403,174546,4857,2.7
47151,2018,8273,7905,368,4.4
47153,2018,6093,5828,265,4.3
47155,2018,53188,51325,1863,3.5
47157,2018,441691,423270,18421,4.2
47159,2018,9207,8925,282,3.1
47161,2018,5298,5034,264,5
47163,2018,70347,67740,2607,3.7
47165,2018,99758,96967,2791,2.8
47167,2018,27985,26799,1186,4.2
47169,2018,5291,5119,172,3.3
47171,2018,7038,6690,348,4.9
47173,2018,7518,7210,308,4.1
47175,2018,2062,1963,99,4.8
47177,2018,16750,16080,670,4
47179,2018,59996,57862,2134,3.6
47181,2018,6146,5848,298,4.8
47183,2018,15961,15283,678,4.2
47185,2018,12258,11814,444,3.6
47187,2018,125087,121954,3133,2.5
47189,2018,74665,72580,2085,2.8
48001,2018,23397,22675,722,3.1
48003,2018,9414,9189,225,2.4
48005,2018,36046,34486,1560,4.3
48007,2018,9567,9002,565,5.9
48009,2018,4142,4016,126,3
48011,2018,922,897,25,2.7
48013,2018,21413,20611,802,3.7
48015,2018,13864,13359,505,3.6
48017,2018,2619,2505,114,4.4
48019,2018,9939,9603,336,3.4
48021,2018,41673,40276,1397,3.4
48023,2018,1555,1506,49,3.2
48025,2018,9940,9438,502,5.1
48027,2018,142598,136734,5864,4.1
48029,2018,936251,905106,31145,3.3
48031,2018,6250,6088,162,2.6
48033,2018,343,332,11,3.2
48035,2018,8217,7914,303,3.7
48037,2018,39474,37542,1932,4.9
48039,2018,176559,168602,7957,4.5
48041,2018,116493,113189,3304,2.8
48043,2018,4044,3910,134,3.3
48045,2018,559,538,21,3.8
48047,2018,2451,2295,156,6.4
48049,2018,16022,15429,593,3.7
48051,2018,8225,7930,295,3.6
48053,2018,22921,22264,657,2.9
48055,2018,19091,18399,692,3.6
48057,2018,11210,10753,457,4.1
48059,2018,5985,5785,200,3.3
48061,2018,165894,155750,10144,6.1
48063,2018,5000,4757,243,4.9
48065,2018,2996,2912,84,2.8
48067,2018,12296,11680,616,5
48069,2018,3464,3366,98,2.8
48071,2018,19269,18238,1031,5.4
48073,2018,20899,20044,855,4.1
48075,2018,2951,2874,77,2.6
48077,2018,4926,4771,155,3.1
48079,2018,1099,1052,47,4.3
48081,2018,1454,1405,49,3.4
48083,2018,2939,2824,115,3.9
48085,2018,551491,533254,18237,3.3
48087,2018,1182,1145,37,3.1
48089,2018,9674,9359,315,3.3
48091,2018,72381,70087,2294,3.2
48093,2018,5372,5181,191,3.6
48095,2018,1098,1058,40,3.6
48097,2018,19176,18587,589,3.1
48099,2018,23895,22900,995,4.2
48101,2018,532,509,23,4.3
48103,2018,1780,1712,68,3.8
48105,2018,1633,1586,47,2.9
48107,2018,2485,2371,114,4.6
48109,2018,976,946,30,3.1
48111,2018,4041,3959,82,2
48113,2018,1336810,1286399,50411,3.8
48115,2018,4563,4368,195,4.3
48117,2018,8426,8192,234,2.8
48119,2018,2446,2362,84,3.4
48121,2018,483765,468392,15373,3.2
48123,2018,9724,9422,302,3.1
48125,2018,673,645,28,4.2
48127,2018,7358,7139,219,3
48129,2018,1558,1505,53,3.4
48131,2018,5065,4802,263,5.2
48133,2018,8673,8385,288,3.3
48135,2018,85645,83346,2299,2.7
48137,2018,883,858,25,2.8
48139,2018,90694,87710,2984,3.3
48141,2018,358355,343330,15025,4.2
48143,2018,20753,20118,635,3.1
48145,2018,6513,6261,252,3.9
48147,2018,16459,15954,505,3.1
48149,2018,12598,12248,350,2.8
48151,2018,1651,1598,53,3.2
48153,2018,2671,2533,138,5.2
48155,2018,584,567,17,2.9
48157,2018,386546,371320,15226,3.9
48159,2018,4565,4378,187,4.1
48161,2018,6552,6170,382,5.8
48163,2018,10187,9899,288,2.8
48165,2018,9427,9188,239,2.5
48167,2018,163247,155732,7515,4.6
48169,2018,2136,2074,62,2.9
48171,2018,13380,13043,337,2.5
48173,2018,852,835,17,2
48175,2018,3282,3158,124,3.8
48177,2018,9486,9200,286,3
48179,2018,8127,7813,314,3.9
48181,2018,63270,61205,2065,3.3
48183,2018,57476,55120,2356,4.1
48185,2018,11113,10658,455,4.1
48187,2018,80305,77802,2503,3.1
48189,2018,12491,11898,593,4.7
48191,2018,1110,1061,49,4.4
48193,2018,3635,3516,119,3.3
48195,2018,2854,2788,66,2.3
48197,2018,1678,1618,60,3.6
48199,2018,25388,24082,1306,5.1
48201,2018,2286360,2186339,100021,4.4
48203,2018,29928,28635,1293,4.3
48205,2018,2863,2812,51,1.8
48207,2018,2355,2265,90,3.8
48209,2018,116188,112777,3411,2.9
48211,2018,2248,2202,46,2
48213,2018,36145,34791,1354,3.7
48215,2018,347594,324843,22751,6.5
48217,2018,16288,15700,588,3.6
48219,2018,11434,11082,352,3.1
48221,2018,27052,26062,990,3.7
48223,2018,17323,16742,581,3.4
48225,2018,10201,9823,378,3.7
48227,2018,13596,13152,444,3.3
48229,2018,1802,1720,82,4.6
48231,2018,42504,40897,1607,3.8
48233,2018,8994,8550,444,4.9
48235,2018,766,743,23,3
48237,2018,4378,4269,109,2.5
48239,2018,7367,7128,239,3.2
48241,2018,13233,12376,857,6.5
48243,2018,1069,1038,31,2.9
48245,2018,107196,100432,6764,6.3
48247,2018,1878,1772,106,5.6
48249,2018,16986,16071,915,5.4
48251,2018,80465,77721,2744,3.4
48253,2018,5619,5352,267,4.8
48255,2018,6861,6667,194,2.8
48257,2018,63141,60970,2171,3.4
48259,2018,21859,21227,632,2.9
48261,2018,247,238,9,3.6
48263,2018,452,441,11,2.4
48265,2018,21800,21101,699,3.2
48267,2018,1874,1818,56,3
48269,2018,211,205,6,2.8
48271,2018,1352,1293,59,4.4
48273,2018,13312,12657,655,4.9
48275,2018,1452,1400,52,3.6
48277,2018,23767,22874,893,3.8
48279,2018,5210,4982,228,4.4
48281,2018,9150,8810,340,3.7
48283,2018,4585,4475,110,2.4
48285,2018,8786,8514,272,3.1
48287,2018,9473,9185,288,3
48289,2018,6127,5823,304,5
48291,2018,32719,30831,1888,5.8
48293,2018,8406,8019,387,4.6
48295,2018,1652,1607,45,2.7
48297,2018,5181,4987,194,3.7
48299,2018,8519,8205,314,3.7
48301,2018,268,264,4,1.5
48303,2018,156533,151778,4755,3
48305,2018,2748,2659,89,3.2
48307,2018,3749,3626,123,3.3
48309,2018,118211,114001,4210,3.6
48311,2018,716,703,13,1.8
48313,2018,4564,4365,199,4.4
48315,2018,4252,4062,190,4.5
48317,2018,2770,2702,68,2.5
48319,2018,1775,1720,55,3.1
48321,2018,16801,15780,1021,6.1
48323,2018,23635,21720,1915,8.1
48325,2018,21557,20813,744,3.5
48327,2018,827,794,33,4
48329,2018,102959,100784,2175,2.1
48331,2018,9887,9347,540,5.5
48333,2018,1870,1805,65,3.5
48335,2018,2326,2230,96,4.1
48337,2018,9138,8850,288,3.2
48339,2018,279663,269261,10402,3.7
48341,2018,10870,10583,287,2.6
48343,2018,4709,4401,308,6.5
48345,2018,463,446,17,3.7
48347,2018,28654,27548,1106,3.9
48349,2018,23650,22784,866,3.7
48351,2018,5187,4841,346,6.7
48353,2018,6718,6499,219,3.3
48355,2018,167850,160082,7768,4.6
48357,2018,4456,4333,123,2.8
48359,2018,906,882,24,2.6
48361,2018,36517,34418,2099,5.7
48363,2018,13501,13053,448,3.3
48365,2018,10700,10256,444,4.1
48367,2018,65949,63922,2027,3.1
48369,2018,4887,4773,114,2.3
48371,2018,6417,6185,232,3.6
48373,2018,17837,16941,896,5
48375,2018,54901,53305,1596,2.9
48377,2018,3040,2831,209,6.9
48379,2018,5908,5704,204,3.5
48381,2018,71644,69789,1855,2.6
48383,2018,1874,1828,46,2.5
48385,2018,1049,997,52,5
48387,2018,5087,4814,273,5.4
48389,2018,9411,9217,194,2.1
48391,2018,3136,2993,143,4.6
48393,2018,428,416,12,2.8
48395,2018,7535,7223,312,4.1
48397,2018,50929,49296,1633,3.2
48399,2018,4576,4434,142,3.1
48401,2018,22768,21847,921,4
48403,2018,3544,3265,279,7.9
48405,2018,3005,2813,192,6.4
48407,2018,11516,10948,568,4.9
48409,2018,30078,28185,1893,6.3
48411,2018,2538,2461,77,3
48413,2018,1370,1331,39,2.8
48415,2018,6928,6695,233,3.4
48417,2018,1943,1899,44,2.3
48419,2018,11022,10551,471,4.3
48421,2018,1330,1295,35,2.6
48423,2018,106822,102951,3871,3.6
48425,2018,4292,4116,176,4.1
48427,2018,25170,22642,2528,10
48429,2018,3995,3851,144,3.6
48431,2018,581,562,19,3.3
48433,2018,590,570,20,3.4
48435,2018,1458,1402,56,3.8
48437,2018,2653,2540,113,4.3
48439,2018,1059957,1023016,36941,3.5
48441,2018,65343,63293,2050,3.1
48443,2018,378,365,13,3.4
48445,2018,5131,4923,208,4.1
48447,2018,701,678,23,3.3
48449,2018,12897,12252,645,5
48451,2018,54646,52939,1707,3.1
48453,2018,719238,698868,20370,2.8
48455,2018,5314,5042,272,5.1
48457,2018,6980,6521,459,6.6
48459,2018,17674,16938,736,4.2
48461,2018,1580,1526,54,3.4
48463,2018,11466,10981,485,4.2
48465,2018,22423,21560,863,3.8
48467,2018,25757,24859,898,3.5
48469,2018,42955,41321,1634,3.8
48471,2018,23877,22883,994,4.2
48473,2018,23141,22162,979,4.2
48475,2018,6774,6602,172,2.5
48477,2018,14872,14336,536,3.6
48479,2018,116294,111939,4355,3.7
48481,2018,21284,20500,784,3.7
48483,2018,2427,2351,76,3.1
48485,2018,56368,54461,1907,3.4
48487,2018,4978,4772,206,4.1
48489,2018,6389,5762,627,9.800000000000001
48491,2018,304215,294970,9245,3
48493,2018,24547,23798,749,3.1
48495,2018,4026,3912,114,2.8
48497,2018,31252,30184,1068,3.4
48499,2018,17356,16621,735,4.2
48501,2018,3714,3608,106,2.9
48503,2018,8166,7904,262,3.2
48505,2018,5358,5063,295,5.5
48507,2018,3559,3219,340,9.6
49001,2018,3005,2902,103,3.4
49003,2018,25442,24693,749,2.9
49005,2018,63252,61598,1654,2.6
49007,2018,8461,8090,371,4.4
49009,2018,398,381,17,4.3
49011,2018,169969,165119,4850,2.9
49013,2018,7712,7369,343,4.4
49015,2018,4321,4119,202,4.7
49017,2018,2773,2561,212,7.6
49019,2018,6056,5775,281,4.6
49021,2018,22861,22062,799,3.5
49023,2018,5564,5401,163,2.9
49025,2018,3785,3666,119,3.1
49027,2018,6200,6002,198,3.2
49029,2018,5440,5293,147,2.7
49031,2018,480,455,25,5.2
49033,2018,1171,1134,37,3.2
49035,2018,619396,601161,18235,2.9
49037,2018,5700,5353,347,6.1
49039,2018,12448,11995,453,3.6
49041,2018,9863,9519,344,3.5
49043,2018,24353,23633,720,3
49045,2018,33206,32099,1107,3.3
49047,2018,13583,12961,622,4.6
49049,2018,299036,290741,8295,2.8
49051,2018,15128,14660,468,3.1
49053,2018,74034,71555,2479,3.3
49055,2018,1427,1343,84,5.9
49057,2018,124906,120651,4255,3.4
50001,2018,20722,20215,507,2.4
50003,2018,18307,17757,550,3
50005,2018,14678,14218,460,3.1
50007,2018,97097,95189,1908,2
50009,2018,2692,2599,93,3.5
50011,2018,27570,26906,664,2.4
50013,2018,4070,3945,125,3.1
50015,2018,13968,13495,473,3.4
50017,2018,15933,15527,406,2.5
50019,2018,13501,12924,577,4.3
50021,2018,30752,29828,924,3
50023,2018,34512,33658,854,2.5
50025,2018,22470,21856,614,2.7
50027,2018,29034,28384,650,2.2
51001,2018,16748,16099,649,3.9
51003,2018,56203,54672,1531,2.7
51005,2018,6930,6669,261,3.8
51007,2018,6208,6001,207,3.3
51009,2018,14944,14444,500,3.3
51011,2018,7119,6855,264,3.7
51013,2018,152218,149115,3103,2
51015,2018,36797,35783,1014,2.8
51017,2018,2513,2450,63,2.5
51019,2018,38270,37083,1187,3.1
51021,2018,2833,2742,91,3.2
51023,2018,17282,16811,471,2.7
51025,2018,6000,5699,301,5
51027,2018,6928,6545,383,5.5
51029,2018,6313,6027,286,4.5
51031,2018,25890,25002,888,3.4
51033,2018,15146,14611,535,3.5
51035,2018,13289,12802,487,3.7
51036,2018,3643,3495,148,4.1
51037,2018,5209,5015,194,3.7
51041,2018,186121,180588,5533,3
51043,2018,7500,7280,220,2.9
51045,2018,2290,2207,83,3.6
51047,2018,24278,23569,709,2.9
51049,2018,4648,4494,154,3.3
51051,2018,4523,4287,236,5.2
51053,2018,13551,13069,482,3.6
51057,2018,5507,5293,214,3.9
51059,2018,626912,611282,15630,2.5
51061,2018,36681,35709,972,2.6
51063,2018,8108,7884,224,2.8
51065,2018,13667,13319,348,2.5
51067,2018,26182,25363,819,3.1
51069,2018,47352,46098,1254,2.6
51071,2018,7835,7569,266,3.4
51073,2018,19481,18948,533,2.7
51075,2018,11124,10788,336,3
51077,2018,7667,7430,237,3.1
51079,2018,10306,10042,264,2.6
51081,2018,4371,4209,162,3.7
51083,2018,15155,14525,630,4.2
51085,2018,58777,57218,1559,2.7
51087,2018,180763,175257,5506,3
51089,2018,23672,22781,891,3.8
51091,2018,1255,1220,35,2.8
51093,2018,19348,18766,582,3
51095,2018,36496,35422,1074,2.9
51097,2018,3851,3732,119,3.1
51099,2018,13194,12799,395,3
51101,2018,9082,8810,272,3
51103,2018,5292,5059,233,4.4
51105,2018,8308,7961,347,4.2
51107,2018,219593,214065,5528,2.5
51109,2018,19758,19200,558,2.8
51111,2018,5320,5146,174,3.3
51113,2018,7272,7092,180,2.5
51115,2018,4122,3997,125,3
51117,2018,12667,12145,522,4.1
51119,2018,5230,5087,143,2.7
51121,2018,49859,48368,1491,3
51125,2018,7318,7088,230,3.1
51127,2018,12396,12055,341,2.8
51131,2018,5385,5090,295,5.5
51133,2018,5540,5291,249,4.5
51135,2018,7211,6986,225,3.1
51137,2018,17013,16492,521,3.1
51139,2018,11893,11389,504,4.2
51141,2018,7435,7144,291,3.9
51143,2018,30488,29391,1097,3.6
51145,2018,14025,13644,381,2.7
51147,2018,10402,9997,405,3.9
51149,2018,14987,14434,553,3.7
51153,2018,242475,235713,6762,2.8
51155,2018,15972,15412,560,3.5
51157,2018,3640,3538,102,2.8
51159,2018,4050,3922,128,3.2
51161,2018,49067,47711,1356,2.8
51163,2018,10567,10246,321,3
51165,2018,41080,39968,1112,2.7
51167,2018,11186,10702,484,4.3
51169,2018,9100,8799,301,3.3
51171,2018,22169,21528,641,2.9
51173,2018,13661,13109,552,4
51175,2018,9029,8774,255,2.8
51177,2018,66153,64094,2059,3.1
51179,2018,71131,68995,2136,3
51181,2018,3750,3620,130,3.5
51183,2018,3761,3572,189,5
51185,2018,15911,15199,712,4.5
51187,2018,20169,19540,629,3.1
51191,2018,26663,25748,915,3.4
51193,2018,9371,9023,348,3.7
51195,2018,13210,12548,662,5
51197,2018,13727,13208,519,3.8
51199,2018,32656,31730,926,2.8
51510,2018,99979,97676,2303,2.3
51520,2018,7177,6903,274,3.8
51530,2018,3351,3244,107,3.2
51540,2018,25963,25291,672,2.6
51550,2018,122298,118533,3765,3.1
51570,2018,8738,8442,296,3.4
51580,2018,2400,2286,114,4.8
51590,2018,19576,18569,1007,5.1
51595,2018,2333,2221,112,4.8
51600,2018,13271,12963,308,2.3
51610,2018,8480,8295,185,2.2
51620,2018,3589,3430,159,4.4
51630,2018,13963,13471,492,3.5
51640,2018,2929,2827,102,3.5
51650,2018,64262,61619,2643,4.1
51660,2018,24557,23686,871,3.5
51670,2018,9648,9178,470,4.9
51678,2018,2079,1979,100,4.8
51680,2018,36249,34770,1479,4.1
51683,2018,21770,21174,596,2.7
51685,2018,9261,9005,256,2.8
51690,2018,5470,5215,255,4.7
51700,2018,88574,85305,3269,3.7
51710,2018,111338,107224,4114,3.7
51720,2018,1665,1598,67,4
51730,2018,12988,12179,809,6.2
51735,2018,6361,6188,173,2.7
51740,2018,44163,42331,1832,4.1
51750,2018,8615,8283,332,3.9
51760,2018,117557,113337,4220,3.6
51770,2018,48878,47272,1606,3.3
51775,2018,12902,12513,389,3
51790,2018,12016,11667,349,2.9
51800,2018,44502,43044,1458,3.3
51810,2018,232337,225561,6776,2.9
51820,2018,10520,10175,345,3.3
51830,2018,6673,6399,274,4.1
51840,2018,14544,14105,439,3
53001,2018,9382,8859,523,5.6
53003,2018,10189,9739,450,4.4
53005,2018,99023,93702,5321,5.4
53007,2018,45126,43003,2123,4.7
53009,2018,28122,26281,1841,6.5
53011,2018,233059,221615,11444,4.9
53013,2018,1793,1691,102,5.7
53015,2018,46339,43525,2814,6.1
53017,2018,21753,20567,1186,5.5
53019,2018,2513,2214,299,11.9
53021,2018,41673,39069,2604,6.2
53023,2018,905,851,54,6
53025,2018,46546,43563,2983,6.4
53027,2018,28263,26315,1948,6.9
53029,2018,34676,32817,1859,5.4
53031,2018,12270,11543,727,5.9
53033,2018,1264754,1224648,40106,3.2
53035,2018,123493,117634,5859,4.7
53037,2018,22030,20795,1235,5.6
53039,2018,10094,9507,587,5.8
53041,2018,33941,31756,2185,6.4
53043,2018,5075,4822,253,5
53045,2018,24457,22873,1584,6.5
53047,2018,20622,19258,1364,6.6
53049,2018,8419,7824,595,7.1
53051,2018,4847,4492,355,7.3
53053,2018,425870,403258,22612,5.3
53055,2018,8280,7949,331,4
53057,2018,60564,57337,3227,5.3
53059,2018,5354,5048,306,5.7
53061,2018,430814,415930,14884,3.5
53063,2018,245323,232197,13126,5.4
53065,2018,18393,17050,1343,7.3
53067,2018,138067,131291,6776,4.9
53069,2018,1333,1242,91,6.8
53071,2018,29350,27930,1420,4.8
53073,2018,111677,106221,5456,4.9
53075,2018,23546,22486,1060,4.5
53077,2018,129078,120677,8401,6.5
54001,2018,6857,6449,408,6
54003,2018,57407,55083,2324,4
54005,2018,7440,6988,452,6.1
54007,2018,5093,4737,356,7
54009,2018,9849,9253,596,6.1
54011,2018,40980,39056,1924,4.7
54013,2018,2414,2164,250,10.4
54015,2018,3117,2856,261,8.4
54017,2018,3952,3798,154,3.9
54019,2018,15872,14869,1003,6.3
54021,2018,2363,2214,149,6.3
54023,2018,5811,5482,329,5.7
54025,2018,15611,14823,788,5
54027,2018,10386,9945,441,4.2
54029,2018,12872,12119,753,5.8
54031,2018,5773,5457,316,5.5
54033,2018,34049,32518,1531,4.5
54035,2018,16170,15527,643,4
54037,2018,29656,28667,989,3.3
54039,2018,82348,78131,4217,5.1
54041,2018,6661,6292,369,5.5
54043,2018,7111,6622,489,6.9
54045,2018,10726,9988,738,6.9
54047,2018,4456,4040,416,9.300000000000001
54049,2018,25192,23758,1434,5.7
54051,2018,14133,13317,816,5.8
54053,2018,9917,9228,689,6.9
54055,2018,20969,19659,1310,6.2
54057,2018,12277,11607,670,5.5
54059,2018,6835,6320,515,7.5
54061,2018,53643,51459,2184,4.1
54063,2018,5787,5510,277,4.8
54065,2018,7956,7616,340,4.3
54067,2018,9282,8688,594,6.4
54069,2018,21308,20333,975,4.6
54071,2018,3531,3400,131,3.7
54073,2018,2841,2666,175,6.2
54075,2018,3797,3565,232,6.1
54077,2018,15320,14522,798,5.2
54079,2018,26351,25064,1287,4.9
54081,2018,29681,28139,1542,5.2
54083,2018,12021,11364,657,5.5
54085,2018,4309,4080,229,5.3
54087,2018,4943,4558,385,7.8
54089,2018,4207,3951,256,6.1
54091,2018,7776,7401,375,4.8
54093,2018,3326,3144,182,5.5
54095,2018,3097,2873,224,7.2
54097,2018,9388,8855,533,5.7
54099,2018,15587,14664,923,5.9
54101,2018,3167,2967,200,6.3
54103,2018,6554,6088,466,7.1
54105,2018,2210,2057,153,6.9
54107,2018,36019,34067,1952,5.4
54109,2018,6799,6327,472,6.9
55001,2018,8178,7792,386,4.7
55003,2018,7905,7568,337,4.3
55005,2018,24910,24067,843,3.4
55007,2018,7573,7203,370,4.9
55009,2018,142639,138718,3921,2.7
55011,2018,6597,6370,227,3.4
55013,2018,7295,6961,334,4.6
55015,2018,27704,26988,716,2.6
55017,2018,33354,32250,1104,3.3
55019,2018,18024,17504,520,2.9
55021,2018,31463,30610,853,2.7
55023,2018,7838,7547,291,3.7
55025,2018,319942,312787,7155,2.2
55027,2018,47964,46703,1261,2.6
55029,2018,15420,14863,557,3.6
55031,2018,23217,22295,922,4
55033,2018,24367,23623,744,3.1
55035,2018,59051,57513,1538,2.6
55037,2018,2266,2181,85,3.8
55039,2018,57227,55712,1515,2.6
55041,2018,3975,3784,191,4.8
55043,2018,28240,27447,793,2.8
55045,2018,21060,20518,542,2.6
55047,2018,9707,9383,324,3.3
55049,2018,13793,13431,362,2.6
55051,2018,2575,2425,150,5.8
55053,2018,10567,10237,330,3.1
55055,2018,46054,44733,1321,2.9
55057,2018,13506,13093,413,3.1
55059,2018,89475,86327,3148,3.5
55061,2018,11201,10877,324,2.9
55063,2018,66930,65176,1754,2.6
55065,2018,10211,9976,235,2.3
55067,2018,9483,9107,376,4
55069,2018,15267,14788,479,3.1
55071,2018,41215,39938,1277,3.1
55073,2018,73923,71966,1957,2.6
55075,2018,19602,18816,786,4
55077,2018,7695,7422,273,3.5
55078,2018,1625,1532,93,5.7
55079,2018,468452,451475,16977,3.6
55081,2018,23545,22900,645,2.7
55083,2018,20770,20081,689,3.3
55085,2018,18155,17505,650,3.6
55087,2018,103341,100447,2894,2.8
55089,2018,49249,48012,1237,2.5
55091,2018,4225,4087,138,3.3
55093,2018,25465,24650,815,3.2
55095,2018,24584,23670,914,3.7
55097,2018,39071,37897,1174,3
55099,2018,6631,6386,245,3.7
55101,2018,99130,95551,3579,3.6
55103,2018,9295,9050,245,2.6
55105,2018,84967,82214,2753,3.2
55107,2018,6954,6678,276,4
55109,2018,50461,48932,1529,3
55111,2018,35559,34648,911,2.6
55113,2018,7950,7607,343,4.3
55115,2018,21401,20756,645,3
55117,2018,62511,60949,1562,2.5
55119,2018,11035,10689,346,3.1
55121,2018,16313,15847,466,2.9
55123,2018,15461,15015,446,2.9
55125,2018,10151,9749,402,4
55127,2018,58245,56532,1713,2.9
55129,2018,7914,7607,307,3.9
55131,2018,77555,75584,1971,2.5
55133,2018,225674,219707,5967,2.6
55135,2018,26253,25480,773,2.9
55137,2018,11602,11198,404,3.5
55139,2018,92128,89613,2515,2.7
55141,2018,35223,34006,1217,3.5
56001,2018,20361,19712,649,3.2
56003,2018,5263,5025,238,4.5
56005,2018,22993,22090,903,3.9
56007,2018,7851,7570,281,3.6
56009,2018,7636,7368,268,3.5
56011,2018,3726,3610,116,3.1
56013,2018,18890,17939,951,5
56015,2018,6831,6613,218,3.2
56017,2018,2229,2151,78,3.5
56019,2018,4235,4073,162,3.8
56021,2018,48190,46397,1793,3.7
56023,2018,8785,8463,322,3.7
56025,2018,39259,37509,1750,4.5
56027,2018,1282,1248,34,2.7
56029,2018,15591,14936,655,4.2
56031,2018,4784,4612,172,3.6
56033,2018,15732,15121,611,3.9
56035,2018,4249,4074,175,4.1
56037,2018,21285,20425,860,4
56039,2018,15405,14959,446,2.9
56041,2018,9028,8650,378,4.2
56043,2018,4058,3892,166,4.1
56045,2018,3767,3641,126,3.3
72001,2018,4024,3473,551,13.7
72003,2018,11809,10500,1309,11.1
72005,2018,14615,12804,1811,12.4
72007,2018,6464,5813,651,10.1
72009,2018,6414,5649,765,11.9
72011,2018,8784,7941,843,9.6
72013,2018,23193,20786,2407,10.4
72015,2018,4614,3982,632,13.7
72017,2018,5809,5126,683,11.8
72019,2018,7336,6590,746,10.2
72021,2018,63973,59624,4349,6.8
72023,2018,13573,12156,1417,10.4
72025,2018,47130,43469,3661,7.8
72027,2018,9282,8368,914,9.800000000000001
72029,2018,15884,14635,1249,7.9
72031,2018,60556,56445,4111,6.8
72033,2018,7698,7081,617,8
72035,2018,15832,14608,1224,7.7
72037,2018,3764,3252,512,13.6
72039,2018,3670,3213,457,12.5
72041,2018,15223,14068,1155,7.6
72043,2018,9881,8513,1368,13.8
72045,2018,4853,4354,499,10.3
72047,2018,8855,8020,835,9.4
72049,2018,891,852,39,4.4
72051,2018,12843,12095,748,5.8
72053,2018,11140,9570,1570,14.1
72054,2018,3288,2897,391,11.9
72055,2018,3914,3309,605,15.5
72057,2018,11036,9568,1468,13.3
72059,2018,4913,4206,707,14.4
72061,2018,36693,35084,1609,4.4
72063,2018,17774,16639,1135,6.4
72065,2018,13114,11450,1664,12.7
72067,2018,5401,4871,530,9.800000000000001
72069,2018,16999,15035,1964,11.6
72071,2018,12339,11031,1308,10.6
72073,2018,4105,3669,436,10.6
72075,2018,14774,13227,1547,10.5
72077,2018,12145,10993,1152,9.5
72079,2018,5219,4420,799,15.3
72081,2018,6952,5828,1124,16.2
72083,2018,2610,2242,368,14.1
72085,2018,11111,10038,1073,9.699999999999999
72087,2018,8283,7594,689,8.300000000000001
72089,2018,6317,5465,852,13.5
72091,2018,11344,10367,977,8.6
72093,2018,1898,1612,286,15.1
72095,2018,2886,2446,440,15.2
72097,2018,21886,19396,2490,11.4
72099,2018,10482,9250,1232,11.8
72101,2018,7863,7100,763,9.699999999999999
72103,2018,8130,7230,900,11.1
72105,2018,7041,6350,691,9.800000000000001
72107,2018,4979,4366,613,12.3
72109,2018,4366,3600,766,17.5
72111,2018,5740,4949,791,13.8
72113,2018,44584,40201,4383,9.800000000000001
72115,2018,5979,5155,824,13.8
72117,2018,4697,4029,668,14.2
72119,2018,16861,15310,1551,9.199999999999999
72121,2018,6099,5250,849,13.9
72123,2018,7125,6074,1051,14.8
72125,2018,9621,8447,1174,12.2
72127,2018,131456,123248,8208,6.2
72129,2018,11588,10419,1169,10.1
72131,2018,10238,8739,1499,14.6
72133,2018,8641,7531,1110,12.8
72135,2018,26601,24932,1669,6.3
72137,2018,28742,26842,1900,6.6
72139,2018,26462,25086,1376,5.2
72141,2018,6604,5840,764,11.6
72143,2018,9560,8718,842,8.800000000000001
72145,2018,13117,11750,1367,10.4
72147,2018,2718,2269,449,16.5
72149,2018,7311,6154,1157,15.8
72151,2018,8762,7509,1253,14.3
72153,2018,9716,8288,1428,14.7
,,,,,
,,,,,
,,,,,
1001,2019,26172,25458,714,2.7
1003,2019,97328,94675,2653,2.7
1005,2019,8537,8213,324,3.8
1007,2019,8685,8419,266,3.1
1009,2019,25331,24655,676,2.7
1011,2019,4818,4643,175,3.6
1013,2019,9263,8925,338,3.6
1015,2019,46209,44574,1635,3.5
1017,2019,15748,15286,462,2.9
1019,2019,11604,11266,338,2.9
1021,2019,19818,19280,538,2.7
1023,2019,4670,4452,218,4.7
1025,2019,7557,7121,436,5.8
1027,2019,6101,5918,183,3
1029,2019,5806,5623,183,3.2
1031,2019,21402,20779,623,2.9
1033,2019,23646,22761,885,3.7
1035,2019,4533,4353,180,4
1037,2019,4549,4414,135,3
1039,2019,15653,15119,534,3.4
1041,2019,6476,6293,183,2.8
1043,2019,38646,37648,998,2.6
1045,2019,20724,20082,642,3.1
1047,2019,14711,13904,807,5.5
1049,2019,31052,30182,870,2.8
1051,2019,37565,36586,979,2.6
1053,2019,14762,14248,514,3.5
1055,2019,42723,41295,1428,3.3
1057,2019,6579,6372,207,3.1
1059,2019,14696,14291,405,2.8
1061,2019,11045,10725,320,2.9
1063,2019,2883,2722,161,5.6
1065,2019,6119,5878,241,3.9
1067,2019,6944,6697,247,3.6
1069,2019,46234,44844,1390,3
1071,2019,23484,22712,772,3.3
1073,2019,318755,309664,9091,2.9
1075,2019,5849,5670,179,3.1
1077,2019,42548,41160,1388,3.3
1079,2019,14306,13859,447,3.1
1081,2019,76580,74500,2080,2.7
1083,2019,43854,42700,1154,2.6
1085,2019,3587,3383,204,5.7
1087,2019,7850,7513,337,4.3
1089,2019,185219,180505,4714,2.5
1091,2019,7694,7423,271,3.5
1093,2019,12932,12486,446,3.4
1095,2019,44085,42999,1086,2.5
1097,2019,189107,182083,7024,3.7
1099,2019,7329,6973,356,4.9
1101,2019,105777,102517,3260,3.1
1103,2019,58271,56771,1500,2.6
1105,2019,3413,3235,178,5.2
1107,2019,7923,7647,276,3.5
1109,2019,15428,14924,504,3.3
1111,2019,9639,9347,292,3
1113,2019,23896,23198,698,2.9
1115,2019,40532,39441,1091,2.7
1117,2019,115939,113414,2525,2.2
1119,2019,4854,4635,219,4.5
1121,2019,35769,34556,1213,3.4
1123,2019,18652,18096,556,3
1125,2019,104964,102122,2842,2.7
1127,2019,25347,24517,830,3.3
1129,2019,6800,6487,313,4.6
1131,2019,2739,2544,195,7.1
1133,2019,10041,9705,336,3.3
2013,2019,2428,2360,68,2.8
2016,2019,3606,3477,129,3.6
2020,2019,146949,139526,7423,5.1
2050,2019,7025,6120,905,12.9
2060,2019,441,414,27,6.1
2068,2019,1038,950,88,8.5
2070,2019,1938,1781,157,8.1
2090,2019,44652,42248,2404,5.4
2100,2019,1111,1012,99,8.9
2105,2019,1160,1028,132,11.4
2110,2019,16999,16243,756,4.4
2122,2019,26161,24383,1778,6.8
2130,2019,6884,6456,428,6.2
2150,2019,5912,5582,330,5.6
2158,2019,2682,2164,518,19.3
2164,2019,708,638,70,9.9
2170,2019,46901,43661,3240,6.9
2180,2019,4036,3596,440,10.9
2185,2019,3485,3261,224,6.4
2188,2019,2934,2523,411,14
2195,2019,1388,1267,121,8.699999999999999
2198,2019,2851,2562,289,10.1
2220,2019,4336,4155,181,4.2
2230,2019,822,746,76,9.199999999999999
2240,2019,2810,2558,252,9
2261,2019,4815,4452,363,7.5
2275,2019,1002,925,77,7.7
2282,2019,246,227,19,7.7
2290,2019,2458,2113,345,14
4001,2019,20487,18468,2019,9.9
4003,2019,50594,47695,2899,5.7
4005,2019,77507,73206,4301,5.5
4007,2019,21677,20485,1192,5.5
4009,2019,15351,14608,743,4.8
4011,2019,4520,4342,178,3.9
4012,2019,9334,8789,545,5.8
4013,2019,2310503,2217656,92847,4
4015,2019,87792,82815,4977,5.7
4017,2019,40979,37973,3006,7.3
4019,2019,498695,476620,22075,4.4
4021,2019,187480,178309,9171,4.9
4023,2019,19636,17963,1673,8.5
4025,2019,106880,102138,4742,4.4
4027,2019,99824,83437,16387,16.4
5001,2019,9427,9141,286,3
5003,2019,7751,7333,418,5.4
5005,2019,16296,15646,650,4
5007,2019,137211,133610,3601,2.6
5009,2019,16036,15525,511,3.2
5011,2019,4483,4298,185,4.1
5013,2019,2453,2345,108,4.4
5015,2019,12783,12383,400,3.1
5017,2019,3285,3057,228,6.9
5019,2019,9691,9323,368,3.8
5021,2019,5691,5413,278,4.9
5023,2019,9226,8808,418,4.5
5025,2019,3219,3092,127,3.9
5027,2019,9140,8730,410,4.5
5029,2019,8285,7926,359,4.3
5031,2019,55652,54097,1555,2.8
5033,2019,26922,26028,894,3.3
5035,2019,21422,20512,910,4.2
5037,2019,7411,7097,314,4.2
5039,2019,2840,2706,134,4.7
5041,2019,5402,5161,241,4.5
5043,2019,7864,7456,408,5.2
5045,2019,62431,60556,1875,3
5047,2019,7494,7242,252,3.4
5049,2019,4962,4763,199,4
5051,2019,41346,39809,1537,3.7
5053,2019,8403,8136,267,3.2
5055,2019,20065,19366,699,3.5
5057,2019,9951,9571,380,3.8
5059,2019,14019,13509,510,3.6
5061,2019,5711,5525,186,3.3
5063,2019,16527,15868,659,4
5065,2019,4912,4643,269,5.5
5067,2019,5840,5460,380,6.5
5069,2019,27740,26220,1520,5.5
5071,2019,10278,9809,469,4.6
5073,2019,2466,2351,115,4.7
5075,2019,6817,6533,284,4.2
5077,2019,2833,2706,127,4.5
5079,2019,3950,3777,173,4.4
5081,2019,5518,5280,238,4.3
5083,2019,8583,8210,373,4.3
5085,2019,34468,33359,1109,3.2
5087,2019,7427,7238,189,2.5
5089,2019,6673,6406,267,4
5091,2019,19750,18941,809,4.1
5093,2019,17358,16467,891,5.1
5095,2019,2761,2642,119,4.3
5097,2019,2970,2832,138,4.6
5099,2019,3662,3517,145,4
5101,2019,3335,3218,117,3.5
5103,2019,9838,9330,508,5.2
5105,2019,4275,4100,175,4.1
5107,2019,6379,5996,383,6
5109,2019,4250,4086,164,3.9
5111,2019,10279,9929,350,3.4
5113,2019,8121,7782,339,4.2
5115,2019,28869,27618,1251,4.3
5117,2019,3586,3430,156,4.4
5119,2019,190248,183776,6472,3.4
5121,2019,7301,7017,284,3.9
5123,2019,8197,7772,425,5.2
5125,2019,59114,57450,1664,2.8
5127,2019,4314,4167,147,3.4
5129,2019,2914,2781,133,4.6
5131,2019,56698,54834,1864,3.3
5133,2019,5513,5248,265,4.8
5135,2019,5742,5457,285,5
5137,2019,4726,4503,223,4.7
5139,2019,15847,15018,829,5.2
5141,2019,5741,5455,286,5
5143,2019,124967,121914,3053,2.4
5145,2019,33800,32281,1519,4.5
5147,2019,2773,2627,146,5.3
5149,2019,8417,8081,336,4
6001,2019,844346,819675,24671,2.9
6003,2019,551,523,28,5.1
6005,2019,14900,14328,572,3.8
6007,2019,99242,94162,5080,5.1
6009,2019,21428,20616,812,3.8
6011,2019,10993,9586,1407,12.8
6013,2019,561757,544496,17261,3.1
6015,2019,9674,9119,555,5.7
6017,2019,92022,88785,3237,3.5
6019,2019,450760,418092,32668,7.2
6021,2019,12997,12201,796,6.1
6023,2019,62507,60254,2253,3.6
6025,2019,71411,58331,13080,18.3
6027,2019,8760,8450,310,3.5
6029,2019,390999,360783,30216,7.7
6031,2019,57788,53222,4566,7.9
6033,2019,29158,27687,1471,5
6035,2019,9869,9416,453,4.6
6037,2019,5121584,4894296,227288,4.4
6039,2019,61945,57651,4294,6.9
6041,2019,139979,136786,3193,2.3
6043,2019,7612,7262,350,4.6
6045,2019,38934,37388,1546,4
6047,2019,116226,106866,9360,8.1
6049,2019,3171,2947,224,7.1
6051,2019,8508,8195,313,3.7
6053,2019,222516,208717,13799,6.2
6055,2019,74004,71900,2104,2.8
6057,2019,48639,47022,1617,3.3
6059,2019,1623421,1578334,45087,2.8
6061,2019,187932,182093,5839,3.1
6063,2019,7903,7296,607,7.7
6065,2019,1104035,1057884,46151,4.2
6067,2019,712394,686298,26096,3.7
6069,2019,31432,29845,1587,5
6071,2019,967719,930709,37010,3.8
6073,2019,1590591,1539948,50643,3.2
6075,2019,583186,570412,12774,2.2
6077,2019,327077,307854,19223,5.9
6079,2019,140931,136914,4017,2.9
6081,2019,460044,450647,9397,2
6083,2019,217882,209843,8039,3.7
6085,2019,1053723,1027527,26196,2.5
6087,2019,142277,135530,6747,4.7
6089,2019,74353,70878,3475,4.7
6091,2019,1326,1255,71,5.4
6093,2019,17227,16109,1118,6.5
6095,2019,209527,201672,7855,3.7
6097,2019,259394,252428,6966,2.7
6099,2019,243454,228753,14701,6
6101,2019,45785,42440,3345,7.3
6103,2019,25650,24228,1422,5.5
6105,2019,4693,4436,257,5.5
6107,2019,203980,184353,19627,9.6
6109,2019,21317,20366,951,4.5
6111,2019,423390,408169,15221,3.6
6113,2019,108658,104220,4438,4.1
6115,2019,29997,28182,1815,6.1
8001,2019,275440,267375,8065,2.9
8003,2019,8726,8413,313,3.6
8005,2019,368504,358574,9930,2.7
8007,2019,6937,6717,220,3.2
8009,2019,2175,2138,37,1.7
8011,2019,1919,1863,56,2.9
8013,2019,196991,192351,4640,2.4
8014,2019,40520,39528,992,2.4
8015,2019,9871,9636,235,2.4
8017,2019,1173,1154,19,1.6
8019,2019,6110,5960,150,2.5
8021,2019,4165,4013,152,3.6
8023,2019,1888,1814,74,3.9
8025,2019,1525,1460,65,4.3
8027,2019,2088,2025,63,3
8029,2019,14519,14035,484,3.3
8031,2019,421322,409974,11348,2.7
8033,2019,1164,1129,35,3
8035,2019,196248,191586,4662,2.4
8037,2019,37073,36241,832,2.2
8039,2019,15344,15009,335,2.2
8041,2019,342735,331453,11282,3.3
8043,2019,15251,14548,703,4.6
8045,2019,32910,32021,889,2.7
8047,2019,3820,3732,88,2.3
8049,2019,9978,9765,213,2.1
8051,2019,11594,11346,248,2.1
8053,2019,438,422,16,3.7
8055,2019,2542,2396,146,5.7
8057,2019,1003,980,23,2.3
8059,2019,338722,330124,8598,2.5
8061,2019,965,950,15,1.6
8063,2019,4365,4292,73,1.7
8065,2019,4994,4878,116,2.3
8067,2019,32305,31495,810,2.5
8069,2019,206483,201624,4859,2.4
8071,2019,6635,6377,258,3.9
8073,2019,2431,2375,56,2.3
8075,2019,11167,10904,263,2.4
8077,2019,76614,73986,2628,3.4
8079,2019,533,521,12,2.3
8081,2019,7450,7195,255,3.4
8083,2019,13038,12486,552,4.2
8085,2019,22010,21327,683,3.1
8087,2019,16582,16146,436,2.6
8089,2019,8495,8150,345,4.1
8091,2019,2454,2383,71,2.9
8093,2019,11292,11010,282,2.5
8095,2019,2631,2589,42,1.6
8097,2019,11395,11041,354,3.1
8099,2019,6408,6240,168,2.6
8101,2019,76276,73147,3129,4.1
8103,2019,3019,2908,111,3.7
8105,2019,5506,5280,226,4.1
8107,2019,16491,16132,359,2.2
8109,2019,3606,3462,144,4
8111,2019,570,553,17,3
8113,2019,5900,5737,163,2.8
8115,2019,1231,1206,25,2
8117,2019,23179,22760,419,1.8
8119,2019,12821,12425,396,3.1
8121,2019,3000,2941,59,2
8123,2019,170001,165670,4331,2.5
8125,2019,6224,6126,98,1.6
9001,2019,481023,463547,17476,3.6
9003,2019,483303,464533,18770,3.9
9005,2019,105182,101543,3639,3.5
9007,2019,93696,90703,2993,3.2
9009,2019,461613,443514,18099,3.9
9011,2019,137386,132423,4963,3.6
9013,2019,87047,84207,2840,3.3
9015,2019,64281,61697,2584,4
10001,2019,79411,76097,3314,4.2
10003,2019,300148,289100,11048,3.7
10005,2019,107706,103648,4058,3.8
11001,2019,409969,387482,22487,5.5
12001,2019,139217,135112,4105,2.9
12003,2019,11852,11484,368,3.1
12005,2019,84235,80980,3255,3.9
12007,2019,11062,10715,347,3.1
12009,2019,284087,275025,9062,3.2
12011,2019,1040519,1008813,31706,3
12013,2019,4819,4622,197,4.1
12015,2019,71865,69239,2626,3.7
12017,2019,47377,45096,2281,4.8
12019,2019,107718,104467,3251,3
12021,2019,180626,175040,5586,3.1
12023,2019,29797,28831,966,3.2
12027,2019,14185,13686,499,3.5
12029,2019,5828,5606,222,3.8
12031,2019,491946,475890,16056,3.3
12033,2019,145919,141253,4666,3.2
12035,2019,47030,45235,1795,3.8
12037,2019,4650,4486,164,3.5
12039,2019,18833,18061,772,4.1
12041,2019,7145,6900,245,3.4
12043,2019,5384,5173,211,3.9
12045,2019,5772,5495,277,4.8
12047,2019,4340,4162,178,4.1
12049,2019,8502,8074,428,5
12051,2019,15587,14680,907,5.8
12053,2019,71923,68906,3017,4.2
12055,2019,36094,34452,1642,4.5
12057,2019,750269,727117,23152,3.1
12059,2019,6947,6701,246,3.5
12061,2019,65457,62949,2508,3.8
12063,2019,17145,16522,623,3.6
12065,2019,5623,5436,187,3.3
12067,2019,2855,2769,86,3
12069,2019,159027,153919,5108,3.2
12071,2019,348027,337116,10911,3.1
12073,2019,155493,150713,4780,3.1
12075,2019,16725,16104,621,3.7
12077,2019,2639,2545,94,3.6
12079,2019,7469,7188,281,3.8
12081,2019,179993,174382,5611,3.1
12083,2019,137624,132335,5289,3.8
12085,2019,74119,71786,2333,3.1
12086,2019,1383989,1350924,33065,2.4
12087,2019,46755,45792,963,2.1
12089,2019,41210,40000,1210,2.9
12091,2019,96940,94342,2598,2.7
12093,2019,17801,17184,617,3.5
12095,2019,762737,740564,22173,2.9
12097,2019,184329,178283,6046,3.3
12099,2019,733663,709694,23969,3.3
12101,2019,237941,229631,8310,3.5
12103,2019,494185,479472,14713,3
12105,2019,305752,294472,11280,3.7
12107,2019,26563,25413,1150,4.3
12109,2019,132464,128970,3494,2.6
12111,2019,145111,139389,5722,3.9
12113,2019,82903,80448,2455,3
12115,2019,189137,183288,5849,3.1
12117,2019,255529,248085,7444,2.9
12119,2019,32628,31126,1502,4.6
12121,2019,18046,17427,619,3.4
12123,2019,8229,7934,295,3.6
12125,2019,4638,4501,137,3
12127,2019,254312,245545,8767,3.4
12129,2019,14921,14487,434,2.9
12131,2019,31577,30685,892,2.8
12133,2019,9678,9348,330,3.4
13001,2019,9306,8945,361,3.9
13003,2019,4695,4552,143,3
13005,2019,4966,4790,176,3.5
13007,2019,1163,1108,55,4.7
13009,2019,17409,16671,738,4.2
13011,2019,9616,9352,264,2.7
13013,2019,40385,39247,1138,2.8
13015,2019,50539,48885,1654,3.3
13017,2019,5348,5053,295,5.5
13019,2019,7474,7176,298,4
13021,2019,67896,65249,2647,3.9
13023,2019,4531,4303,228,5
13025,2019,7258,6964,294,4.1
13027,2019,6901,6668,233,3.4
13029,2019,18286,17738,548,3
13031,2019,36540,35170,1370,3.7
13033,2019,9154,8689,465,5.1
13035,2019,10737,10377,360,3.4
13037,2019,2233,2152,81,3.6
13039,2019,20869,20113,756,3.6
13043,2019,5548,5383,165,3
13045,2019,55210,53325,1885,3.4
13047,2019,33517,32518,999,3
13049,2019,4785,4604,181,3.8
13051,2019,139657,135052,4605,3.3
13053,2019,1997,1906,91,4.6
13055,2019,10307,9795,512,5
13057,2019,135814,132118,3696,2.7
13059,2019,59096,56997,2099,3.6
13061,2019,880,819,61,6.9
13063,2019,137796,131980,5816,4.2
13065,2019,2654,2550,104,3.9
13067,2019,425167,412592,12575,3
13069,2019,18869,18138,731,3.9
13071,2019,21377,20702,675,3.2
13073,2019,75134,72860,2274,3
13075,2019,7988,7718,270,3.4
13077,2019,74594,72410,2184,2.9
13079,2019,5605,5404,201,3.6
13081,2019,9433,9065,368,3.9
13083,2019,8209,7941,268,3.3
13085,2019,12320,11971,349,2.8
13087,2019,11540,11101,439,3.8
13089,2019,399354,385700,13654,3.4
13091,2019,7081,6700,381,5.4
13093,2019,5071,4880,191,3.8
13095,2019,38327,36509,1818,4.7
13097,2019,73217,70640,2577,3.5
13099,2019,4372,4201,171,3.9
13101,2019,1909,1856,53,2.8
13103,2019,30889,30000,889,2.9
13105,2019,7658,7352,306,4
13107,2019,8287,7847,440,5.3
13109,2019,4862,4698,164,3.4
13111,2019,11512,11132,380,3.3
13113,2019,57985,56256,1729,3
13115,2019,44144,42455,1689,3.8
13117,2019,122076,118737,3339,2.7
13119,2019,9942,9592,350,3.5
13121,2019,556954,537605,19349,3.5
13123,2019,11861,11444,417,3.5
13125,2019,1272,1225,47,3.7
13127,2019,39345,38039,1306,3.3
13129,2019,27976,27025,951,3.4
13131,2019,10449,10093,356,3.4
13133,2019,7010,6740,270,3.9
13135,2019,489610,474882,14728,3
13137,2019,19069,18411,658,3.5
13139,2019,102061,99222,2839,2.8
13141,2019,2447,2312,135,5.5
13143,2019,12557,12141,416,3.3
13145,2019,16649,16139,510,3.1
13147,2019,11303,10903,400,3.5
13149,2019,5248,5073,175,3.3
13151,2019,115495,111409,4086,3.5
13153,2019,70345,68005,2340,3.3
13155,2019,3328,3172,156,4.7
13157,2019,36518,35550,968,2.7
13159,2019,6939,6726,213,3.1
13161,2019,6051,5772,279,4.6
13163,2019,6572,6260,312,4.7
13165,2019,3143,2983,160,5.1
13167,2019,4036,3889,147,3.6
13169,2019,13696,13262,434,3.2
13171,2019,8232,7914,318,3.9
13173,2019,3748,3601,147,3.9
13175,2019,19142,18269,873,4.6
13177,2019,14717,14268,449,3.1
13179,2019,26096,25119,977,3.7
13181,2019,3554,3417,137,3.9
13183,2019,8137,7841,296,3.6
13185,2019,51180,49376,1804,3.5
13187,2019,16719,16200,519,3.1
13189,2019,8852,8402,450,5.1
13191,2019,6167,5948,219,3.6
13193,2019,4693,4476,217,4.6
13195,2019,13282,12877,405,3
13197,2019,3305,3165,140,4.2
13199,2019,8911,8510,401,4.5
13201,2019,2749,2659,90,3.3
13205,2019,8445,8060,385,4.6
13207,2019,12995,12574,421,3.2
13209,2019,3807,3607,200,5.3
13211,2019,9240,8953,287,3.1
13213,2019,15505,14725,780,5
13215,2019,77490,73977,3513,4.5
13217,2019,52197,50187,2010,3.9
13219,2019,19510,19014,496,2.5
13221,2019,6929,6706,223,3.2
13223,2019,85916,83397,2519,2.9
13225,2019,11826,11343,483,4.1
13227,2019,15271,14816,455,3
13229,2019,8698,8404,294,3.4
13231,2019,8899,8631,268,3
13233,2019,18429,17761,668,3.6
13235,2019,4052,3896,156,3.8
13237,2019,8185,7831,354,4.3
13239,2019,800,760,40,5
13241,2019,7152,6900,252,3.5
13243,2019,2527,2405,122,4.8
13245,2019,85085,81242,3843,4.5
13247,2019,44751,43061,1690,3.8
13249,2019,2200,2115,85,3.9
13251,2019,5088,4813,275,5.4
13253,2019,3037,2903,134,4.4
13255,2019,28675,27530,1145,4
13257,2019,10685,10273,412,3.9
13259,2019,2396,2296,100,4.2
13261,2019,12686,12077,609,4.8
13263,2019,2819,2693,126,4.5
13265,2019,567,539,28,4.9
13267,2019,9560,9194,366,3.8
13269,2019,3074,2950,124,4
13271,2019,4107,3716,391,9.5
13273,2019,3510,3333,177,5
13275,2019,16470,15807,663,4
13277,2019,19751,19088,663,3.4
13279,2019,11655,11079,576,4.9
13281,2019,3893,3705,188,4.8
13283,2019,2642,2503,139,5.3
13285,2019,37304,36117,1187,3.2
13287,2019,3139,3019,120,3.8
13289,2019,2878,2722,156,5.4
13291,2019,10274,9953,321,3.1
13293,2019,11320,10916,404,3.6
13295,2019,31358,30242,1116,3.6
13297,2019,46011,44601,1410,3.1
13299,2019,15555,14986,569,3.7
13301,2019,2821,2693,128,4.5
13303,2019,7013,6722,291,4.1
13305,2019,11403,10947,456,4
13307,2019,1007,957,50,5
13309,2019,1610,1490,120,7.5
13311,2019,16266,15836,430,2.6
13313,2019,43564,41637,1927,4.4
13315,2019,2695,2575,120,4.5
13317,2019,3823,3650,173,4.5
13319,2019,3959,3808,151,3.8
13321,2019,8897,8552,345,3.9
15001,2019,91161,88018,3143,3.4
15003,2019,450562,438936,11626,2.6
15007,2019,36536,35558,978,2.7
15009,2019,86733,84461,2272,2.6
16001,2019,254224,247855,6369,2.5
16003,2019,1721,1604,117,6.8
16005,2019,42752,41546,1206,2.8
16007,2019,2978,2891,87,2.9
16009,2019,4109,3894,215,5.2
16011,2019,23817,23182,635,2.7
16013,2019,12318,11995,323,2.6
16015,2019,3516,3365,151,4.3
16017,2019,20058,19222,836,4.2
16019,2019,57042,55678,1364,2.4
16021,2019,5376,5138,238,4.4
16023,2019,1397,1360,37,2.6
16025,2019,695,676,19,2.7
16027,2019,104402,101058,3344,3.2
16029,2019,4135,4025,110,2.7
16031,2019,12215,11920,295,2.4
16033,2019,378,364,14,3.7
16035,2019,2905,2708,197,6.8
16037,2019,2228,2134,94,4.2
16039,2019,11547,11169,378,3.3
16041,2019,7041,6876,165,2.3
16043,2019,7870,7686,184,2.3
16045,2019,8308,8035,273,3.3
16047,2019,8222,8005,217,2.6
16049,2019,6563,6265,298,4.5
16051,2019,14035,13709,326,2.3
16053,2019,12199,11884,315,2.6
16055,2019,80102,77257,2845,3.6
16057,2019,20549,19994,555,2.7
16059,2019,3566,3396,170,4.8
16061,2019,1648,1558,90,5.5
16063,2019,2703,2607,96,3.6
16065,2019,21941,21539,402,1.8
16067,2019,11442,11151,291,2.5
16069,2019,21057,20459,598,2.8
16071,2019,2321,2268,53,2.3
16073,2019,5434,5251,183,3.4
16075,2019,11663,11248,415,3.6
16077,2019,4092,3965,127,3.1
16079,2019,5143,4839,304,5.9
16081,2019,6626,6480,146,2.2
16083,2019,41393,40234,1159,2.8
16085,2019,5554,5338,216,3.9
16087,2019,4612,4420,192,4.2
17001,2019,32358,31249,1109,3.4
17003,2019,2050,1923,127,6.2
17005,2019,7833,7533,300,3.8
17007,2019,26377,24890,1487,5.6
17009,2019,2993,2921,72,2.4
17011,2019,17392,16585,807,4.6
17013,2019,2338,2225,113,4.8
17015,2019,7325,7022,303,4.1
17017,2019,6131,5878,253,4.1
17019,2019,109116,105014,4102,3.8
17021,2019,14615,13910,705,4.8
17023,2019,7693,7345,348,4.5
17025,2019,6508,6212,296,4.5
17027,2019,20548,19908,640,3.1
17029,2019,23855,22889,966,4
17031,2019,2594759,2496526,98233,3.8
17033,2019,8715,8340,375,4.3
17035,2019,6125,5915,210,3.4
17037,2019,55397,53115,2282,4.1
17039,2019,7490,7165,325,4.3
17041,2019,10263,9897,366,3.6
17043,2019,507802,492985,14817,2.9
17045,2019,9019,8636,383,4.2
17047,2019,2715,2604,111,4.1
17049,2019,19370,18740,630,3.3
17051,2019,9940,9504,436,4.4
17053,2019,6490,6211,279,4.3
17055,2019,16456,15565,891,5.4
17057,2019,15262,14409,853,5.6
17059,2019,2359,2244,115,4.9
17061,2019,6036,5776,260,4.3
17063,2019,25443,24307,1136,4.5
17065,2019,4449,4277,172,3.9
17067,2019,8464,8067,397,4.7
17069,2019,1318,1231,87,6.6
17071,2019,3638,3463,175,4.8
17073,2019,25217,24015,1202,4.8
17075,2019,14481,13873,608,4.2
17077,2019,28083,27012,1071,3.8
17079,2019,4667,4469,198,4.2
17081,2019,17525,16720,805,4.6
17083,2019,11044,10555,489,4.4
17085,2019,10869,10428,441,4.1
17087,2019,4155,3905,250,6
17089,2019,274298,262136,12162,4.4
17091,2019,56207,53396,2811,5
17093,2019,68630,66358,2272,3.3
17095,2019,21856,20771,1085,5
17097,2019,378425,362822,15603,4.1
17099,2019,55002,52081,2921,5.3
17101,2019,5913,5606,307,5.2
17103,2019,17724,17018,706,4
17105,2019,16663,15984,679,4.1
17107,2019,12739,12185,554,4.3
17109,2019,13458,12830,628,4.7
17111,2019,165574,160086,5488,3.3
17113,2019,88460,85134,3326,3.8
17115,2019,48905,46328,2577,5.3
17117,2019,23125,22136,989,4.3
17119,2019,134999,129708,5291,3.9
17121,2019,17680,16889,791,4.5
17123,2019,5366,5108,258,4.8
17125,2019,6342,6004,338,5.3
17127,2019,5652,5336,316,5.6
17129,2019,6542,6295,247,3.8
17131,2019,8168,7761,407,5
17133,2019,18902,18313,589,3.1
17135,2019,11823,11207,616,5.2
17137,2019,16578,15910,668,4
17139,2019,7638,7384,254,3.3
17141,2019,25162,23947,1215,4.8
17143,2019,85453,81085,4368,5.1
17145,2019,8391,7960,431,5.1
17147,2019,8632,8319,313,3.6
17149,2019,7057,6751,306,4.3
17151,2019,1693,1599,94,5.6
17153,2019,1996,1865,131,6.6
17155,2019,3066,2912,154,5
17157,2019,14371,13842,529,3.7
17159,2019,7273,6975,298,4.1
17161,2019,71937,68377,3560,4.9
17163,2019,127362,121685,5677,4.5
17165,2019,9702,9188,514,5.3
17167,2019,101644,97552,4092,4
17169,2019,3277,3139,138,4.2
17171,2019,2530,2410,120,4.7
17173,2019,10695,10278,417,3.9
17175,2019,2555,2409,146,5.7
17177,2019,21823,20868,955,4.4
17179,2019,64182,61347,2835,4.4
17181,2019,7494,7070,424,5.7
17183,2019,33251,31540,1711,5.1
17185,2019,5874,5648,226,3.8
17187,2019,8556,8207,349,4.1
17189,2019,10254,9995,259,2.5
17191,2019,7031,6696,335,4.8
17193,2019,6663,6409,254,3.8
17195,2019,28849,27619,1230,4.3
17197,2019,357236,343602,13634,3.8
17199,2019,32146,30765,1381,4.3
17201,2019,140238,132290,7948,5.7
17203,2019,18870,18165,705,3.7
18001,2019,17255,16785,470,2.7
18003,2019,186799,180923,5876,3.1
18005,2019,45027,43902,1125,2.5
18007,2019,4582,4436,146,3.2
18009,2019,5006,4808,198,4
18011,2019,36450,35553,897,2.5
18013,2019,7750,7518,232,3
18015,2019,10276,9967,309,3
18017,2019,17995,17366,629,3.5
18019,2019,61893,59835,2058,3.3
18021,2019,12124,11694,430,3.5
18023,2019,17231,16769,462,2.7
18025,2019,4874,4672,202,4.1
18027,2019,16772,16337,435,2.6
18029,2019,25931,25010,921,3.6
18031,2019,15052,14618,434,2.9
18033,2019,22758,22116,642,2.8
18035,2019,53945,51853,2092,3.9
18037,2019,23145,22590,555,2.4
18039,2019,112941,109468,3473,3.1
18041,2019,8791,8375,416,4.7
18043,2019,41797,40476,1321,3.2
18045,2019,8060,7777,283,3.5
18047,2019,11446,11052,394,3.4
18049,2019,9916,9601,315,3.2
18051,2019,19534,19043,491,2.5
18053,2019,31833,30648,1185,3.7
18055,2019,13728,13164,564,4.1
18057,2019,184661,180004,4657,2.5
18059,2019,40470,39317,1153,2.8
18061,2019,20386,19727,659,3.2
18063,2019,90412,87966,2446,2.7
18065,2019,22165,21435,730,3.3
18067,2019,36915,35432,1483,4
18069,2019,18344,17745,599,3.3
18071,2019,22962,22356,606,2.6
18073,2019,16435,15831,604,3.7
18075,2019,9503,9216,287,3
18077,2019,15078,14567,511,3.4
18079,2019,13599,13151,448,3.3
18081,2019,83375,81134,2241,2.7
18083,2019,18584,18011,573,3.1
18085,2019,42438,41248,1190,2.8
18087,2019,20073,19514,559,2.8
18089,2019,232451,221096,11355,4.9
18091,2019,48062,46012,2050,4.3
18093,2019,21247,20481,766,3.6
18095,2019,59452,57262,2190,3.7
18097,2019,492967,476851,16116,3.3
18099,2019,23239,22513,726,3.1
18101,2019,5380,5239,141,2.6
18103,2019,15517,14911,606,3.9
18105,2019,70338,68000,2338,3.3
18107,2019,18852,18275,577,3.1
18109,2019,36532,35404,1128,3.1
18111,2019,7035,6746,289,4.1
18113,2019,23760,23023,737,3.1
18115,2019,3201,3089,112,3.5
18117,2019,8653,8353,300,3.5
18119,2019,9413,9038,375,4
18121,2019,7116,6847,269,3.8
18123,2019,9306,8998,308,3.3
18125,2019,6151,5948,203,3.3
18127,2019,87566,84303,3263,3.7
18129,2019,13680,13306,374,2.7
18131,2019,6569,6367,202,3.1
18133,2019,16868,16286,582,3.5
18135,2019,11347,10922,425,3.7
18137,2019,14326,13860,466,3.3
18139,2019,9004,8763,241,2.7
18141,2019,136431,131498,4933,3.6
18143,2019,10600,10221,379,3.6
18145,2019,23275,22600,675,2.9
18147,2019,10841,10501,340,3.1
18149,2019,9963,9531,432,4.3
18151,2019,20785,20232,553,2.7
18153,2019,8444,8085,359,4.3
18155,2019,5024,4857,167,3.3
18157,2019,99148,96245,2903,2.9
18159,2019,9337,9084,253,2.7
18161,2019,3574,3457,117,3.3
18163,2019,94928,92022,2906,3.1
18165,2019,7041,6675,366,5.2
18167,2019,48492,46409,2083,4.3
18169,2019,15101,14630,471,3.1
18171,2019,4225,4098,127,3
18173,2019,33195,32233,962,2.9
18175,2019,13771,13315,456,3.3
18177,2019,30881,29776,1105,3.6
18179,2019,14514,14123,391,2.7
18181,2019,13577,13210,367,2.7
18183,2019,17881,17354,527,2.9
19001,2019,4281,4180,101,2.4
19003,2019,2209,2171,38,1.7
19005,2019,7490,7227,263,3.5
19007,2019,6044,5829,215,3.6
19009,2019,3172,3093,79,2.5
19011,2019,13745,13339,406,3
19013,2019,70280,68011,2269,3.2
19015,2019,15151,14791,360,2.4
19017,2019,14103,13774,329,2.3
19019,2019,11481,11163,318,2.8
19021,2019,11924,11673,251,2.1
19023,2019,8015,7758,257,3.2
19025,2019,4312,4202,110,2.6
19027,2019,11106,10890,216,1.9
19029,2019,6998,6800,198,2.8
19031,2019,11010,10738,272,2.5
19033,2019,23919,23262,657,2.7
19035,2019,6243,6086,157,2.5
19037,2019,6605,6416,189,2.9
19039,2019,4943,4799,144,2.9
19041,2019,8624,8385,239,2.8
19043,2019,10301,9925,376,3.7
19045,2019,23154,22291,863,3.7
19047,2019,8266,7971,295,3.6
19049,2019,50365,49377,988,2
19051,2019,4263,4141,122,2.9
19053,2019,4453,4354,99,2.2
19055,2019,10720,10468,252,2.4
19057,2019,19587,18810,777,4
19059,2019,10228,9933,295,2.9
19061,2019,56937,55435,1502,2.6
19063,2019,5332,5196,136,2.6
19065,2019,10750,10367,383,3.6
19067,2019,8977,8657,320,3.6
19069,2019,5795,5659,136,2.3
19071,2019,3732,3629,103,2.8
19073,2019,5499,5367,132,2.4
19075,2019,6623,6440,183,2.8
19077,2019,5703,5533,170,3
19079,2019,7014,6814,200,2.9
19081,2019,5995,5850,145,2.4
19083,2019,8201,7939,262,3.2
19085,2019,7480,7297,183,2.4
19087,2019,9932,9668,264,2.7
19089,2019,5256,5108,148,2.8
19091,2019,5190,5052,138,2.7
19093,2019,4190,4107,83,2
19095,2019,10686,10450,236,2.2
19097,2019,11166,10814,352,3.2
19099,2019,20067,19478,589,2.9
19101,2019,10253,10002,251,2.4
19103,2019,87724,85941,1783,2
19105,2019,10876,10532,344,3.2
19107,2019,5309,5136,173,3.3
19109,2019,8537,8347,190,2.2
19111,2019,16350,15706,644,3.9
19113,2019,124290,120668,3622,2.9
19115,2019,6135,5947,188,3.1
19117,2019,4700,4603,97,2.1
19119,2019,7165,7047,118,1.6
19121,2019,8722,8404,318,3.6
19123,2019,12034,11729,305,2.5
19125,2019,18614,18215,399,2.1
19127,2019,18204,17381,823,4.5
19129,2019,7509,7334,175,2.3
19131,2019,6952,6834,118,1.7
19133,2019,4509,4375,134,3
19135,2019,4080,3955,125,3.1
19137,2019,5077,4942,135,2.7
19139,2019,22175,21539,636,2.9
19141,2019,8367,8186,181,2.2
19143,2019,3578,3509,69,1.9
19145,2019,6478,6310,168,2.6
19147,2019,4855,4747,108,2.2
19149,2019,15033,14695,338,2.2
19151,2019,4589,4501,88,1.9
19153,2019,273646,265893,7753,2.8
19155,2019,49299,48101,1198,2.4
19157,2019,10539,10258,281,2.7
19159,2019,2511,2439,72,2.9
19161,2019,5363,5236,127,2.4
19163,2019,90711,87687,3024,3.3
19165,2019,6801,6657,144,2.1
19167,2019,21340,20939,401,1.9
19169,2019,59215,58115,1100,1.9
19171,2019,9608,9308,300,3.1
19173,2019,3247,3185,62,1.9
19175,2019,6375,6169,206,3.2
19177,2019,3714,3613,101,2.7
19179,2019,18068,17404,664,3.7
19181,2019,28783,28053,730,2.5
19183,2019,12211,11908,303,2.5
19185,2019,2848,2774,74,2.6
19187,2019,19774,19159,615,3.1
19189,2019,5195,5051,144,2.8
19191,2019,12125,11779,346,2.9
19193,2019,56509,54977,1532,2.7
19195,2019,4269,4149,120,2.8
19197,2019,7050,6867,183,2.6
20001,2019,6436,6209,227,3.5
20003,2019,4178,4041,137,3.3
20005,2019,6987,6626,361,5.2
20007,2019,2319,2261,58,2.5
20009,2019,13526,13103,423,3.1
20011,2019,6700,6416,284,4.2
20013,2019,5352,5183,169,3.2
20015,2019,32491,31442,1049,3.2
20017,2019,1524,1482,42,2.8
20019,2019,1434,1378,56,3.9
20021,2019,10136,9788,348,3.4
20023,2019,1310,1278,32,2.4
20025,2019,1072,1047,25,2.3
20027,2019,3777,3656,121,3.2
20029,2019,3787,3665,122,3.2
20031,2019,4023,3841,182,4.5
20033,2019,869,846,23,2.6
20035,2019,16298,15749,549,3.4
20037,2019,18729,18003,726,3.9
20039,2019,1235,1198,37,3
20041,2019,8842,8528,314,3.6
20043,2019,4143,4004,139,3.4
20045,2019,65375,63457,1918,2.9
20047,2019,1488,1450,38,2.6
20049,2019,1152,1109,43,3.7
20051,2019,17036,16649,387,2.3
20053,2019,2748,2671,77,2.8
20055,2019,20602,20121,481,2.3
20057,2019,17088,16664,424,2.5
20059,2019,14023,13557,466,3.3
20061,2019,11311,10811,500,4.4
20063,2019,1468,1437,31,2.1
20065,2019,1114,1080,34,3.1
20067,2019,3218,3126,92,2.9
20069,2019,3230,3166,64,2
20071,2019,798,780,18,2.3
20073,2019,3238,3136,102,3.2
20075,2019,1613,1583,30,1.9
20077,2019,2875,2802,73,2.5
20079,2019,16990,16496,494,2.9
20081,2019,2208,2158,50,2.3
20083,2019,987,963,24,2.4
20085,2019,7167,6959,208,2.9
20087,2019,10096,9788,308,3.1
20089,2019,1291,1255,36,2.8
20091,2019,338777,329456,9321,2.8
20093,2019,2047,1999,48,2.3
20095,2019,3434,3325,109,3.2
20097,2019,1297,1267,30,2.3
20099,2019,10029,9629,400,4
20101,2019,772,752,20,2.6
20103,2019,36474,35225,1249,3.4
20105,2019,1681,1642,39,2.3
20107,2019,4440,4176,264,5.9
20109,2019,1623,1590,33,2
20111,2019,16666,16099,567,3.4
20113,2019,17171,16789,382,2.2
20115,2019,5991,5814,177,3
20117,2019,5492,5335,157,2.9
20119,2019,2155,2105,50,2.3
20121,2019,17476,16898,578,3.3
20123,2019,3359,3279,80,2.4
20125,2019,14801,14196,605,4.1
20127,2019,2993,2912,81,2.7
20129,2019,1140,1107,33,2.9
20131,2019,5368,5220,148,2.8
20133,2019,6130,5850,280,4.6
20135,2019,1342,1308,34,2.5
20137,2019,2700,2641,59,2.2
20139,2019,7973,7689,284,3.6
20141,2019,2050,2009,41,2
20143,2019,3009,2927,82,2.7
20145,2019,2873,2791,82,2.9
20147,2019,2638,2569,69,2.6
20149,2019,12410,12062,348,2.8
20151,2019,4907,4783,124,2.5
20153,2019,1490,1457,33,2.2
20155,2019,29642,28692,950,3.2
20157,2019,2263,2205,58,2.6
20159,2019,5208,5063,145,2.8
20161,2019,35046,34062,984,2.8
20163,2019,2538,2448,90,3.5
20165,2019,1632,1586,46,2.8
20167,2019,3296,3200,96,2.9
20169,2019,30176,29269,907,3
20171,2019,2832,2778,54,1.9
20173,2019,251155,242477,8678,3.5
20175,2019,9516,9222,294,3.1
20177,2019,90410,87395,3015,3.3
20179,2019,1405,1374,31,2.2
20181,2019,2844,2766,78,2.7
20183,2019,1973,1923,50,2.5
20185,2019,2010,1956,54,2.7
20187,2019,985,960,25,2.5
20189,2019,2543,2476,67,2.6
20191,2019,10903,10537,366,3.4
20193,2019,4305,4208,97,2.3
20195,2019,1416,1376,40,2.8
20197,2019,3647,3529,118,3.2
20199,2019,805,784,21,2.6
20201,2019,2915,2838,77,2.6
20203,2019,1356,1329,27,2
20205,2019,3947,3791,156,4
20207,2019,1608,1540,68,4.2
20209,2019,77251,73917,3334,4.3
21001,2019,7140,6760,380,5.3
21003,2019,9060,8682,378,4.2
21005,2019,12091,11643,448,3.7
21007,2019,3524,3323,201,5.7
21009,2019,18852,18001,851,4.5
21011,2019,4631,4343,288,6.2
21013,2019,8452,7909,543,6.4
21015,2019,71372,68948,2424,3.4
21017,2019,9813,9441,372,3.8
21019,2019,17882,16869,1013,5.7
21021,2019,12586,11999,587,4.7
21023,2019,3843,3656,187,4.9
21025,2019,3493,3231,262,7.5
21027,2019,7946,7523,423,5.3
21029,2019,43068,41294,1774,4.1
21031,2019,5133,4886,247,4.8
21033,2019,5473,5200,273,5
21035,2019,18799,18032,767,4.1
21037,2019,51083,49301,1782,3.5
21039,2019,2235,2142,93,4.2
21041,2019,5329,5117,212,4
21043,2019,9783,8971,812,8.300000000000001
21045,2019,6704,6424,280,4.2
21047,2019,25085,23683,1402,5.6
21049,2019,17255,16576,679,3.9
21051,2019,5196,4831,365,7
21053,2019,4009,3788,221,5.5
21055,2019,3810,3625,185,4.9
21057,2019,3185,3051,134,4.2
21059,2019,47567,45730,1837,3.9
21061,2019,4841,4602,239,4.9
21063,2019,2041,1873,168,8.199999999999999
21065,2019,5388,5120,268,5
21067,2019,175864,170028,5836,3.3
21069,2019,6200,5866,334,5.4
21071,2019,11048,10340,708,6.4
21073,2019,25333,24392,941,3.7
21075,2019,2058,1941,117,5.7
21077,2019,4109,3945,164,4
21079,2019,7710,7352,358,4.6
21081,2019,11795,11307,488,4.1
21083,2019,15849,15122,727,4.6
21085,2019,11029,10477,552,5
21087,2019,5125,4901,224,4.4
21089,2019,13444,12560,884,6.6
21091,2019,3994,3841,153,3.8
21093,2019,49305,47280,2025,4.1
21095,2019,6717,6072,645,9.6
21097,2019,8836,8457,379,4.3
21099,2019,7960,7582,378,4.7
21101,2019,22116,21270,846,3.8
21103,2019,8273,7970,303,3.7
21105,2019,1776,1690,86,4.8
21107,2019,18562,17714,848,4.6
21109,2019,4132,3865,267,6.5
21111,2019,402518,386373,16145,4
21113,2019,26666,25695,971,3.6
21115,2019,6771,6324,447,6.6
21117,2019,88326,85189,3137,3.6
21119,2019,4499,4189,310,6.9
21121,2019,9946,9351,595,6
21123,2019,6008,5737,271,4.5
21125,2019,24692,23483,1209,4.9
21127,2019,5200,4833,367,7.1
21129,2019,2064,1947,117,5.7
21131,2019,2704,2481,223,8.199999999999999
21133,2019,6333,5862,471,7.4
21135,2019,4654,4241,413,8.9
21137,2019,9349,8877,472,5
21139,2019,3669,3459,210,5.7
21141,2019,12621,12112,509,4
21143,2019,3119,2973,146,4.7
21145,2019,29258,27819,1439,4.9
21147,2019,4702,4418,284,6
21149,2019,4233,4046,187,4.4
21151,2019,47575,45743,1832,3.9
21153,2019,3136,2790,346,11
21155,2019,9744,9368,376,3.9
21157,2019,15138,14433,705,4.7
21159,2019,2772,2582,190,6.9
21161,2019,7134,6723,411,5.8
21163,2019,12345,11775,570,4.6
21165,2019,2326,2165,161,6.9
21167,2019,10070,9602,468,4.6
21169,2019,4106,3909,197,4.8
21171,2019,4700,4516,184,3.9
21173,2019,11705,11084,621,5.3
21175,2019,4588,4342,246,5.4
21177,2019,10541,9890,651,6.2
21179,2019,23276,22217,1059,4.5
21181,2019,3295,3149,146,4.4
21183,2019,9827,9326,501,5.1
21185,2019,33501,32403,1098,3.3
21187,2019,5138,4902,236,4.6
21189,2019,1135,1055,80,7
21191,2019,7021,6754,267,3.8
21193,2019,8294,7792,502,6.1
21195,2019,19977,18819,1158,5.8
21197,2019,5046,4775,271,5.4
21199,2019,26745,25493,1252,4.7
21201,2019,819,775,44,5.4
21203,2019,6718,6397,321,4.8
21205,2019,10456,9904,552,5.3
21207,2019,6251,5894,357,5.7
21209,2019,29281,28256,1025,3.5
21211,2019,25657,24781,876,3.4
21213,2019,8943,8538,405,4.5
21215,2019,10268,9903,365,3.6
21217,2019,12757,12212,545,4.3
21219,2019,5447,5232,215,3.9
21221,2019,6024,5741,283,4.7
21223,2019,3902,3732,170,4.4
21225,2019,6139,5863,276,4.5
21227,2019,65388,62844,2544,3.9
21229,2019,6267,6022,245,3.9
21231,2019,7465,7033,432,5.8
21233,2019,5790,5556,234,4
21235,2019,13737,13029,708,5.2
21237,2019,1968,1828,140,7.1
21239,2019,14949,14481,468,3.1
22001,2019,23841,22572,1269,5.3
22003,2019,8811,8312,499,5.7
22005,2019,63953,61318,2635,4.1
22007,2019,8877,8335,542,6.1
22009,2019,15109,14226,883,5.8
22011,2019,14606,13849,757,5.2
22013,2019,5516,5190,326,5.9
22015,2019,57604,55129,2475,4.3
22017,2019,103405,97859,5546,5.4
22019,2019,106140,101802,4338,4.1
22021,2019,3773,3544,229,6.1
22023,2019,3937,3789,148,3.8
22025,2019,3379,3162,217,6.4
22027,2019,5837,5506,331,5.7
22029,2019,7019,6566,453,6.5
22031,2019,10853,10201,652,6
22033,2019,230493,220337,10156,4.4
22035,2019,1888,1688,200,10.6
22037,2019,7973,7606,367,4.6
22039,2019,11889,11186,703,5.9
22041,2019,7363,6834,529,7.2
22043,2019,8171,7696,475,5.8
22045,2019,28099,26574,1525,5.4
22047,2019,14040,13207,833,5.9
22049,2019,6802,6480,322,4.7
22051,2019,213704,204775,8929,4.2
22053,2019,13231,12607,624,4.7
22055,2019,113607,108685,4922,4.3
22057,2019,42008,40124,1884,4.5
22059,2019,6715,6429,286,4.3
22061,2019,21959,20780,1179,5.4
22063,2019,68713,65912,2801,4.1
22065,2019,3515,3232,283,8.1
22067,2019,9999,9166,833,8.300000000000001
22069,2019,16343,15356,987,6
22071,2019,178834,170121,8713,4.9
22073,2019,70082,66346,3736,5.3
22075,2019,10053,9620,433,4.3
22077,2019,9867,9339,528,5.4
22079,2019,55062,52258,2804,5.1
22081,2019,3745,3553,192,5.1
22083,2019,8222,7704,518,6.3
22085,2019,9172,8705,467,5.1
22087,2019,19854,18885,969,4.9
22089,2019,25134,24049,1085,4.3
22091,2019,4273,4013,260,6.1
22093,2019,9229,8675,554,6
22095,2019,19647,18545,1102,5.6
22097,2019,31891,29891,2000,6.3
22099,2019,22189,21056,1133,5.1
22101,2019,19816,18643,1173,5.9
22103,2019,119300,114335,4965,4.2
22105,2019,54444,51437,3007,5.5
22107,2019,1398,1282,116,8.300000000000001
22109,2019,46285,44140,2145,4.6
22111,2019,9098,8570,528,5.8
22113,2019,24087,22870,1217,5.1
22115,2019,15883,14906,977,6.2
22117,2019,16703,15713,990,5.9
22119,2019,14493,13609,884,6.1
22121,2019,13648,13029,619,4.5
22123,2019,3630,3243,387,10.7
22125,2019,5378,5158,220,4.1
22127,2019,4867,4558,309,6.3
23001,2019,55225,53594,1631,3
23003,2019,30205,28814,1391,4.6
23005,2019,164832,160912,3920,2.4
23007,2019,14241,13693,548,3.8
23009,2019,29089,28064,1025,3.5
23011,2019,61923,60100,1823,2.9
23013,2019,20194,19605,589,2.9
23015,2019,16789,16290,499,3
23017,2019,26333,25381,952,3.6
23019,2019,76836,74339,2497,3.2
23021,2019,7274,7003,271,3.7
23023,2019,19421,18975,446,2.3
23025,2019,22429,21428,1001,4.5
23027,2019,20613,19953,660,3.2
23029,2019,13688,13053,635,4.6
23031,2019,113644,110554,3090,2.7
24001,2019,32491,30812,1679,5.2
24003,2019,317780,308068,9712,3.1
24005,2019,457555,440638,16917,3.7
24009,2019,50484,48888,1596,3.2
24011,2019,18270,17612,658,3.6
24013,2019,96466,93645,2821,2.9
24015,2019,53453,51323,2130,4
24017,2019,88102,84908,3194,3.6
24019,2019,15684,14938,746,4.8
24021,2019,135761,131453,4308,3.2
24023,2019,15775,15075,700,4.4
24025,2019,142081,137331,4750,3.3
24027,2019,189135,183944,5191,2.7
24029,2019,10205,9796,409,4
24031,2019,565866,549310,16556,2.9
24033,2019,513953,494665,19288,3.8
24035,2019,28079,27210,869,3.1
24037,2019,57409,55506,1903,3.3
24039,2019,9252,8689,563,6.1
24041,2019,19327,18665,662,3.4
24043,2019,75259,72347,2912,3.9
24045,2019,51724,49327,2397,4.6
24047,2019,25814,23908,1906,7.4
24510,2019,290743,275911,14832,5.1
25001,2019,115437,110989,4448,3.9
25003,2019,65320,63035,2285,3.5
25005,2019,304217,292890,11327,3.7
25007,2019,9650,9255,395,4.1
25009,2019,429871,417092,12779,3
25011,2019,41318,40207,1111,2.7
25013,2019,230190,220767,9423,4.1
25015,2019,90937,88479,2458,2.7
25017,2019,929265,907777,21488,2.3
25019,2019,7661,7342,319,4.2
25021,2019,395483,385482,10001,2.5
25023,2019,286588,277913,8675,3
25025,2019,461168,449136,12032,2.6
25027,2019,450332,436193,14139,3.1
26001,2019,3879,3635,244,6.3
26003,2019,3198,2949,249,7.8
26005,2019,62275,60325,1950,3.1
26007,2019,13266,12638,628,4.7
26009,2019,10321,9791,530,5.1
26011,2019,6062,5663,399,6.6
26013,2019,3219,3015,204,6.3
26015,2019,31665,30638,1027,3.2
26017,2019,50038,47704,2334,4.7
26019,2019,8882,8432,450,5.1
26021,2019,73454,70483,2971,4
26023,2019,19356,18600,756,3.9
26025,2019,62502,59943,2559,4.1
26027,2019,24491,23442,1049,4.3
26029,2019,12913,12315,598,4.6
26031,2019,10547,9627,920,8.699999999999999
26033,2019,16031,15022,1009,6.3
26035,2019,11728,11010,718,6.1
26037,2019,41149,39916,1233,3
26039,2019,5599,5285,314,5.6
26041,2019,17181,16282,899,5.2
26043,2019,12297,11777,520,4.2
26045,2019,57251,55295,1956,3.4
26047,2019,17772,16816,956,5.4
26049,2019,182899,173888,9011,4.9
26051,2019,9918,9350,568,5.7
26053,2019,6030,5714,316,5.2
26055,2019,49812,48097,1715,3.4
26057,2019,17998,17209,789,4.4
26059,2019,20446,19592,854,4.2
26061,2019,16183,15388,795,4.9
26063,2019,15401,14723,678,4.4
26065,2019,151261,145943,5318,3.5
26067,2019,30280,29252,1028,3.4
26069,2019,10220,9610,610,6
26071,2019,5162,4878,284,5.5
26073,2019,34741,33405,1336,3.8
26075,2019,74125,71335,2790,3.8
26077,2019,133718,129316,4402,3.3
26079,2019,7935,7487,448,5.6
26081,2019,359924,349535,10389,2.9
26083,2019,884,823,61,6.9
26085,2019,3709,3472,237,6.4
26087,2019,41517,39273,2244,5.4
26089,2019,10531,10139,392,3.7
26091,2019,46454,44663,1791,3.9
26093,2019,104220,100768,3452,3.3
26095,2019,2315,2172,143,6.2
26097,2019,5135,4656,479,9.300000000000001
26099,2019,451125,432001,19124,4.2
26101,2019,10444,9873,571,5.5
26103,2019,32543,30975,1568,4.8
26105,2019,13666,12996,670,4.9
26107,2019,18247,17390,857,4.7
26109,2019,11054,10612,442,4
26111,2019,40325,38826,1499,3.7
26113,2019,6961,6629,332,4.8
26115,2019,75480,72541,2939,3.9
26117,2019,28350,27196,1154,4.1
26119,2019,2998,2748,250,8.300000000000001
26121,2019,77149,73860,3289,4.3
26123,2019,23400,22413,987,4.2
26125,2019,680255,657035,23220,3.4
26127,2019,12120,11403,717,5.9
26129,2019,8030,7494,536,6.7
26131,2019,2090,1947,143,6.8
26133,2019,11202,10749,453,4
26135,2019,3045,2836,209,6.9
26137,2019,11638,11062,576,4.9
26139,2019,161102,156664,4438,2.8
26141,2019,4951,4576,375,7.6
26143,2019,7726,7145,581,7.5
26145,2019,86666,82533,4133,4.8
26147,2019,76280,72546,3734,4.9
26149,2019,27976,26783,1193,4.3
26151,2019,19490,18565,925,4.7
26153,2019,3326,3093,233,7
26155,2019,33496,32070,1426,4.3
26157,2019,23853,22635,1218,5.1
26159,2019,35167,33559,1608,4.6
26161,2019,198198,192472,5726,2.9
26163,2019,808171,767123,41048,5.1
26165,2019,14854,14185,669,4.5
27001,2019,7268,6818,450,6.2
27003,2019,199416,193301,6115,3.1
27005,2019,18833,18086,747,4
27007,2019,24532,23487,1045,4.3
27009,2019,22144,21287,857,3.9
27011,2019,2507,2402,105,4.2
27013,2019,40878,39748,1130,2.8
27015,2019,14435,13912,523,3.6
27017,2019,17927,17126,801,4.5
27019,2019,59102,57473,1629,2.8
27021,2019,14467,13668,799,5.5
27023,2019,6978,6707,271,3.9
27025,2019,30246,29106,1140,3.8
27027,2019,36268,35165,1103,3
27029,2019,4501,4130,371,8.199999999999999
27031,2019,3123,2988,135,4.3
27033,2019,5963,5743,220,3.7
27035,2019,32410,31005,1405,4.3
27037,2019,243793,236782,7011,2.9
27039,2019,11982,11577,405,3.4
27041,2019,21134,20466,668,3.2
27043,2019,7077,6783,294,4.2
27045,2019,11664,11279,385,3.3
27047,2019,16216,15659,557,3.4
27049,2019,27240,26410,830,3
27051,2019,3324,3176,148,4.5
27053,2019,712531,692855,19676,2.8
27055,2019,10451,10115,336,3.2
27057,2019,10036,9495,541,5.4
27059,2019,21503,20632,871,4.1
27061,2019,21963,20656,1307,6
27063,2019,5754,5556,198,3.4
27065,2019,9111,8573,538,5.9
27067,2019,24425,23565,860,3.5
27069,2019,2386,2299,87,3.6
27071,2019,5990,5608,382,6.4
27073,2019,3579,3445,134,3.7
27075,2019,5538,5338,200,3.6
27077,2019,2472,2370,102,4.1
27079,2019,16307,15576,731,4.5
27081,2019,3290,3166,124,3.8
27083,2019,14631,14163,468,3.2
27085,2019,19408,18690,718,3.7
27087,2019,2305,2196,109,4.7
27089,2019,5447,5128,319,5.9
27091,2019,10145,9764,381,3.8
27093,2019,13426,12907,519,3.9
27095,2019,13055,12347,708,5.4
27097,2019,17653,16738,915,5.2
27099,2019,20463,19842,621,3
27101,2019,4877,4668,209,4.3
27103,2019,21098,20564,534,2.5
27105,2019,11289,10950,339,3
27107,2019,3284,3127,157,4.8
27109,2019,89236,86958,2278,2.6
27111,2019,31655,30335,1320,4.2
27113,2019,8765,8365,400,4.6
27115,2019,15154,14318,836,5.5
27117,2019,4950,4778,172,3.5
27119,2019,16672,16007,665,4
27121,2019,6582,6378,204,3.1
27123,2019,292118,283424,8694,3
27125,2019,2229,2111,118,5.3
27127,2019,7676,7392,284,3.7
27129,2019,8669,8275,394,4.5
27131,2019,37333,36169,1164,3.1
27133,2019,5687,5556,131,2.3
27135,2019,7875,7570,305,3.9
27137,2019,102395,98297,4098,4
27139,2019,84276,81967,2309,2.7
27141,2019,52921,51063,1858,3.5
27143,2019,8661,8331,330,3.8
27145,2019,91177,88280,2897,3.2
27147,2019,21221,20549,672,3.2
27149,2019,5478,5330,148,2.7
27151,2019,4953,4737,216,4.4
27153,2019,13615,13012,603,4.4
27155,2019,1781,1715,66,3.7
27157,2019,12432,12018,414,3.3
27159,2019,5962,5595,367,6.2
27161,2019,9059,8709,350,3.9
27163,2019,144620,140553,4067,2.8
27165,2019,6531,6267,264,4
27167,2019,3516,3397,119,3.4
27169,2019,28840,28005,835,2.9
27171,2019,76368,73883,2485,3.3
27173,2019,5409,5204,205,3.8
28001,2019,11260,10466,794,7.1
28003,2019,16057,15300,757,4.7
28005,2019,4417,4109,308,7
28007,2019,7031,6592,439,6.2
28009,2019,3055,2868,187,6.1
28011,2019,12260,11397,863,7
28013,2019,5660,5350,310,5.5
28015,2019,3471,3253,218,6.3
28017,2019,6921,6531,390,5.6
28019,2019,3757,3552,205,5.5
28021,2019,3030,2705,325,10.7
28023,2019,5923,5554,369,6.2
28025,2019,7794,7213,581,7.5
28027,2019,8364,7722,642,7.7
28029,2019,11233,10490,743,6.6
28031,2019,8143,7745,398,4.9
28033,2019,91399,87382,4017,4.4
28035,2019,33282,31575,1707,5.1
28037,2019,2807,2616,191,6.8
28039,2019,8841,8185,656,7.4
28041,2019,4355,4014,341,7.8
28043,2019,9494,9014,480,5.1
28045,2019,18776,17720,1056,5.6
28047,2019,86479,82022,4457,5.2
28049,2019,107145,101524,5621,5.2
28051,2019,5672,5089,583,10.3
28053,2019,2227,2003,224,10.1
28055,2019,381,338,43,11.3
28057,2019,10529,10034,495,4.7
28059,2019,58591,55058,3533,6
28061,2019,6185,5762,423,6.8
28063,2019,2028,1714,314,15.5
28065,2019,4124,3840,284,6.9
28067,2019,26252,24839,1413,5.4
28069,2019,3555,3271,284,8
28071,2019,28393,27113,1280,4.5
28073,2019,30722,29435,1287,4.2
28075,2019,30536,28862,1674,5.5
28077,2019,4623,4310,313,6.8
28079,2019,7968,7527,441,5.5
28081,2019,41209,39409,1800,4.4
28083,2019,10018,9262,756,7.5
28085,2019,14635,13813,822,5.6
28087,2019,25441,24086,1355,5.3
28089,2019,53328,51001,2327,4.4
28091,2019,9940,9397,543,5.5
28093,2019,14505,13673,832,5.7
28095,2019,15534,14683,851,5.5
28097,2019,3960,3721,239,6
28099,2019,10244,9640,604,5.9
28101,2019,8856,8371,485,5.5
28103,2019,3783,3507,276,7.3
28105,2019,22722,21447,1275,5.6
28107,2019,12553,11726,827,6.6
28109,2019,23847,22609,1238,5.2
28111,2019,4293,4004,289,6.7
28113,2019,14519,13575,944,6.5
28115,2019,14773,14133,640,4.3
28117,2019,11338,10781,557,4.9
28119,2019,2378,2182,196,8.199999999999999
28121,2019,76230,73226,3004,3.9
28123,2019,12721,12149,572,4.5
28125,2019,1604,1469,135,8.4
28127,2019,10765,10209,556,5.2
28129,2019,6822,6466,356,5.2
28131,2019,6876,6425,451,6.6
28133,2019,7736,7051,685,8.9
28135,2019,5276,4970,306,5.8
28137,2019,12394,11696,698,5.6
28139,2019,9442,8960,482,5.1
28141,2019,8629,8189,440,5.1
28143,2019,4459,4183,276,6.2
28145,2019,14222,13628,594,4.2
28147,2019,4933,4574,359,7.3
28149,2019,20335,19109,1226,6
28151,2019,16985,15701,1284,7.6
28153,2019,7444,6990,454,6.1
28155,2019,3987,3762,225,5.6
28157,2019,2811,2526,285,10.1
28159,2019,7425,6973,452,6.1
28161,2019,4983,4698,285,5.7
28163,2019,9424,8825,599,6.4
29001,2019,10345,9945,400,3.9
29003,2019,9767,9494,273,2.8
29005,2019,2703,2603,100,3.7
29007,2019,10697,10337,360,3.4
29009,2019,15589,15044,545,3.5
29011,2019,5202,5026,176,3.4
29013,2019,7908,7590,318,4
29015,2019,7201,6855,346,4.8
29017,2019,5484,5270,214,3.9
29019,2019,98300,95937,2363,2.4
29021,2019,44669,43301,1368,3.1
29023,2019,17986,17140,846,4.7
29025,2019,4369,4230,139,3.2
29027,2019,21383,20758,625,2.9
29029,2019,18861,18013,848,4.5
29031,2019,40851,39654,1197,2.9
29033,2019,4808,4653,155,3.2
29035,2019,2546,2421,125,4.9
29037,2019,54895,53239,1656,3
29039,2019,5764,5550,214,3.7
29041,2019,3727,3614,113,3
29043,2019,44998,43771,1227,2.7
29045,2019,3205,3091,114,3.6
29047,2019,136610,132701,3909,2.9
29049,2019,10738,10414,324,3
29051,2019,39051,38037,1014,2.6
29053,2019,7481,7205,276,3.7
29055,2019,10980,10566,414,3.8
29057,2019,3545,3434,111,3.1
29059,2019,7081,6762,319,4.5
29061,2019,4102,3965,137,3.3
29063,2019,4838,4689,149,3.1
29065,2019,6269,6044,225,3.6
29067,2019,5107,4849,258,5.1
29069,2019,11598,10956,642,5.5
29071,2019,53226,51511,1715,3.2
29073,2019,7732,7470,262,3.4
29075,2019,3529,3433,96,2.7
29077,2019,151535,147461,4074,2.7
29079,2019,4394,4240,154,3.5
29081,2019,3822,3695,127,3.3
29083,2019,9728,9364,364,3.7
29085,2019,3842,3681,161,4.2
29087,2019,2588,2515,73,2.8
29089,2019,4898,4746,152,3.1
29091,2019,16541,15870,671,4.1
29093,2019,3534,3365,169,4.8
29095,2019,363539,350008,13531,3.7
29097,2019,57304,55590,1714,3
29099,2019,118177,114498,3679,3.1
29101,2019,23105,22247,858,3.7
29103,2019,1772,1720,52,2.9
29105,2019,17386,16190,1196,6.9
29107,2019,16847,16328,519,3.1
29109,2019,18018,17385,633,3.5
29111,2019,5003,4843,160,3.2
29113,2019,28448,27497,951,3.3
29115,2019,5124,4875,249,4.9
29117,2019,7357,7170,187,2.5
29119,2019,10690,10334,356,3.3
29121,2019,7535,7280,255,3.4
29123,2019,5484,5295,189,3.4
29125,2019,3884,3747,137,3.5
29127,2019,14565,14104,461,3.2
29129,2019,1861,1802,59,3.2
29131,2019,12313,11850,463,3.8
29133,2019,5792,5555,237,4.1
29135,2019,7313,7097,216,3
29137,2019,3872,3711,161,4.2
29139,2019,5738,5558,180,3.1
29141,2019,8127,7776,351,4.3
29143,2019,8236,7880,356,4.3
29145,2019,27392,26498,894,3.3
29147,2019,10790,10468,322,3
29149,2019,3981,3824,157,3.9
29151,2019,7106,6936,170,2.4
29153,2019,3412,3214,198,5.8
29155,2019,6364,6043,321,5
29157,2019,10065,9801,264,2.6
29159,2019,20971,20227,744,3.5
29161,2019,19828,19177,651,3.3
29163,2019,7492,7224,268,3.6
29165,2019,58805,57239,1566,2.7
29167,2019,14584,14081,503,3.4
29169,2019,14692,14094,598,4.1
29171,2019,2291,2207,84,3.7
29173,2019,5662,5484,178,3.1
29175,2019,10380,9978,402,3.9
29177,2019,11033,10632,401,3.6
29179,2019,3042,2929,113,3.7
29181,2019,5039,4761,278,5.5
29183,2019,227085,221305,5780,2.5
29185,2019,3749,3577,172,4.6
29186,2019,9197,8950,247,2.7
29187,2019,26637,25658,979,3.7
29189,2019,533085,516722,16363,3.1
29195,2019,10608,10267,341,3.2
29197,2019,1948,1862,86,4.4
29199,2019,2384,2311,73,3.1
29201,2019,20000,19293,707,3.5
29203,2019,3228,3048,180,5.6
29205,2019,3061,2970,91,3
29207,2019,13098,12480,618,4.7
29209,2019,13873,13185,688,5
29211,2019,2684,2589,95,3.5
29213,2019,27142,25753,1389,5.1
29215,2019,9009,8607,402,4.5
29217,2019,9466,9133,333,3.5
29219,2019,17971,17446,525,2.9
29221,2019,10241,9780,461,4.5
29223,2019,5306,5050,256,4.8
29225,2019,17309,16692,617,3.6
29227,2019,1169,1138,31,2.7
29229,2019,7495,7101,394,5.3
29510,2019,153066,147111,5955,3.9
30001,2019,5071,4922,149,2.9
30003,2019,4832,4475,357,7.4
30005,2019,2487,2399,88,3.5
30007,2019,2585,2482,103,4
30009,2019,5482,5293,189,3.4
30011,2019,644,626,18,2.8
30013,2019,37939,36651,1288,3.4
30015,2019,2455,2389,66,2.7
30017,2019,6060,5886,174,2.9
30019,2019,893,875,18,2
30021,2019,4578,4467,111,2.4
30023,2019,5038,4877,161,3.2
30025,2019,1704,1674,30,1.8
30027,2019,6044,5856,188,3.1
30029,2019,47892,45646,2246,4.7
30031,2019,68760,67205,1555,2.3
30033,2019,738,720,18,2.4
30035,2019,5693,5266,427,7.5
30037,2019,367,352,15,4.1
30039,2019,1687,1591,96,5.7
30041,2019,7641,7360,281,3.7
30043,2019,5698,5509,189,3.3
30045,2019,948,919,29,3.1
30047,2019,13201,12644,557,4.2
30049,2019,35824,34759,1065,3
30051,2019,953,929,24,2.5
30053,2019,8085,7499,586,7.2
30055,2019,951,932,19,2
30057,2019,4808,4654,154,3.2
30059,2019,955,922,33,3.5
30061,2019,1757,1657,100,5.7
30063,2019,63825,61776,2049,3.2
30065,2019,2265,2177,88,3.9
30067,2019,8911,8606,305,3.4
30069,2019,279,269,10,3.6
30071,2019,1883,1813,70,3.7
30073,2019,2671,2570,101,3.8
30075,2019,959,936,23,2.4
30077,2019,2973,2865,108,3.6
30079,2019,477,459,18,3.8
30081,2019,20230,19411,819,4
30083,2019,5880,5724,156,2.7
30085,2019,4502,4308,194,4.3
30087,2019,3827,3635,192,5
30089,2019,4844,4559,285,5.9
30091,2019,1741,1702,39,2.2
30093,2019,17191,16542,649,3.8
30095,2019,5180,5018,162,3.1
30097,2019,1798,1748,50,2.8
30099,2019,2740,2650,90,3.3
30101,2019,2115,2064,51,2.4
30103,2019,334,325,9,2.7
30105,2019,4079,3950,129,3.2
30107,2019,785,755,30,3.8
30109,2019,463,449,14,3
30111,2019,81781,79173,2608,3.2
31001,2019,16792,16262,530,3.2
31003,2019,3558,3467,91,2.6
31005,2019,224,212,12,5.4
31007,2019,377,363,14,3.7
31009,2019,259,246,13,5
31011,2019,2963,2882,81,2.7
31013,2019,5419,5247,172,3.2
31015,2019,1078,1042,36,3.3
31017,2019,1393,1344,49,3.5
31019,2019,27777,27048,729,2.6
31021,2019,3483,3366,117,3.4
31023,2019,4591,4472,119,2.6
31025,2019,13570,13117,453,3.3
31027,2019,4515,4402,113,2.5
31029,2019,2277,2225,52,2.3
31031,2019,3389,3308,81,2.4
31033,2019,4416,4253,163,3.7
31035,2019,3298,3192,106,3.2
31037,2019,5581,5429,152,2.7
31039,2019,4696,4571,125,2.7
31041,2019,6416,6261,155,2.4
31043,2019,10791,10369,422,3.9
31045,2019,4978,4832,146,2.9
31047,2019,13056,12667,389,3
31049,2019,957,929,28,2.9
31051,2019,3034,2941,93,3.1
31053,2019,19501,18931,570,2.9
31055,2019,299587,289816,9771,3.3
31057,2019,1171,1141,30,2.6
31059,2019,3162,3080,82,2.6
31061,2019,1459,1409,50,3.4
31063,2019,1613,1560,53,3.3
31065,2019,2583,2511,72,2.8
31067,2019,11010,10619,391,3.6
31069,2019,1103,1071,32,2.9
31071,2019,1168,1137,31,2.7
31073,2019,1109,1080,29,2.6
31075,2019,424,412,12,2.8
31077,2019,1222,1186,36,2.9
31079,2019,31903,30801,1102,3.5
31081,2019,4769,4624,145,3
31083,2019,1796,1745,51,2.8
31085,2019,613,598,15,2.4
31087,2019,1266,1223,43,3.4
31089,2019,5763,5613,150,2.6
31091,2019,417,404,13,3.1
31093,2019,3365,3247,118,3.5
31095,2019,4143,4030,113,2.7
31097,2019,2064,1992,72,3.5
31099,2019,3791,3705,86,2.3
31101,2019,4592,4444,148,3.2
31103,2019,589,574,15,2.5
31105,2019,2031,1970,61,3
31107,2019,4611,4473,138,3
31109,2019,177186,172276,4910,2.8
31111,2019,18327,17689,638,3.5
31113,2019,473,459,14,3
31115,2019,405,389,16,4
31117,2019,443,431,12,2.7
31119,2019,19816,19258,558,2.8
31121,2019,4013,3885,128,3.2
31123,2019,2607,2532,75,2.9
31125,2019,1976,1917,59,3
31127,2019,3603,3471,132,3.7
31129,2019,2404,2340,64,2.7
31131,2019,8429,8159,270,3.2
31133,2019,1478,1435,43,2.9
31135,2019,1821,1779,42,2.3
31137,2019,4969,4838,131,2.6
31139,2019,4095,3985,110,2.7
31141,2019,17668,17153,515,2.9
31143,2019,2931,2850,81,2.8
31145,2019,5850,5689,161,2.8
31147,2019,4238,4103,135,3.2
31149,2019,871,844,27,3.1
31151,2019,7372,7133,239,3.2
31153,2019,96599,93801,2798,2.9
31155,2019,11169,10858,311,2.8
31157,2019,18287,17614,673,3.7
31159,2019,8931,8669,262,2.9
31161,2019,2673,2599,74,2.8
31163,2019,1691,1637,54,3.2
31165,2019,746,725,21,2.8
31167,2019,3507,3416,91,2.6
31169,2019,2787,2713,74,2.7
31171,2019,423,408,15,3.5
31173,2019,3058,2920,138,4.5
31175,2019,2125,2057,68,3.2
31177,2019,11279,10950,329,2.9
31179,2019,5749,5599,150,2.6
31181,2019,1678,1619,59,3.5
31183,2019,572,556,16,2.8
31185,2019,7278,7083,195,2.7
32001,2019,11057,10666,391,3.5
32003,2019,1131551,1085793,45758,4
32005,2019,23210,22300,910,3.9
32007,2019,27362,26549,813,3
32009,2019,434,418,16,3.7
32011,2019,1095,1069,26,2.4
32013,2019,8251,8009,242,2.9
32015,2019,3214,3112,102,3.2
32017,2019,2113,2029,84,4
32019,2019,23407,22309,1098,4.7
32021,2019,2030,1948,82,4
32023,2019,17297,16415,882,5.1
32027,2019,2563,2460,103,4
32029,2019,2038,1962,76,3.7
32031,2019,255915,247691,8224,3.2
32033,2019,4636,4499,137,3
32510,2019,26282,25248,1034,3.9
33001,2019,31583,30787,796,2.5
33003,2019,23974,23366,608,2.5
33005,2019,40926,39856,1070,2.6
33007,2019,14741,14273,468,3.2
33009,2019,49880,48784,1096,2.2
33011,2019,242579,236216,6363,2.6
33013,2019,83845,81955,1890,2.3
33015,2019,188440,183326,5114,2.7
33017,2019,74621,72875,1746,2.3
33019,2019,23145,22616,529,2.3
34001,2019,120728,114622,6106,5.1
34003,2019,482038,467946,14092,2.9
34005,2019,230589,223049,7540,3.3
34007,2019,253053,242811,10242,4
34009,2019,45947,42660,3287,7.2
34011,2019,65061,61481,3580,5.5
34013,2019,368748,352334,16414,4.5
34015,2019,149747,144238,5509,3.7
34017,2019,361189,349372,11817,3.3
34019,2019,64523,62742,1781,2.8
34021,2019,202885,196458,6427,3.2
34023,2019,439073,425471,13602,3.1
34025,2019,328661,318233,10428,3.2
34027,2019,256698,249463,7235,2.8
34029,2019,275023,264876,10147,3.7
34031,2019,242208,231779,10429,4.3
34033,2019,29180,27771,1409,4.8
34035,2019,171371,166229,5142,3
34037,2019,73963,71425,2538,3.4
34039,2019,276382,266189,10193,3.7
34041,2019,56060,54185,1875,3.3
35001,2019,333865,319048,14817,4.4
35003,2019,1153,1081,72,6.2
35005,2019,27165,25839,1326,4.9
35006,2019,8991,8425,566,6.3
35007,2019,5483,5226,257,4.7
35009,2019,21680,20783,897,4.1
35011,2019,795,761,34,4.3
35013,2019,97527,91976,5551,5.7
35015,2019,34483,33419,1064,3.1
35017,2019,12228,11639,589,4.8
35019,2019,1549,1467,82,5.3
35021,2019,273,259,14,5.1
35023,2019,2091,2002,89,4.3
35025,2019,31282,30054,1228,3.9
35027,2019,8984,8570,414,4.6
35028,2019,9463,9163,300,3.2
35029,2019,10309,9047,1262,12.2
35031,2019,24155,22458,1697,7
35033,2019,2213,2080,133,6
35035,2019,24798,23575,1223,4.9
35037,2019,3229,3062,167,5.2
35039,2019,16835,15951,884,5.3
35041,2019,7901,7545,356,4.5
35043,2019,66475,63268,3207,4.8
35045,2019,51941,48974,2967,5.7
35047,2019,10809,10177,632,5.8
35049,2019,75116,72153,2963,3.9
35051,2019,3893,3628,265,6.8
35053,2019,6446,6071,375,5.8
35055,2019,15218,14303,915,6
35057,2019,5699,5312,387,6.8
35059,2019,1846,1781,65,3.5
35061,2019,30710,29074,1636,5.3
36001,2019,157444,151699,5745,3.6
36003,2019,19441,18380,1061,5.5
36005,2019,597677,565642,32035,5.4
36007,2019,83444,79488,3956,4.7
36009,2019,33884,32172,1712,5.1
36011,2019,35952,34411,1541,4.3
36013,2019,54550,51976,2574,4.7
36015,2019,35019,33543,1476,4.2
36017,2019,22080,21098,982,4.4
36019,2019,36302,34720,1582,4.4
36021,2019,31181,30176,1005,3.2
36023,2019,22853,21735,1118,4.9
36025,2019,19117,18216,901,4.7
36027,2019,144040,138841,5199,3.6
36029,2019,441291,422508,18783,4.3
36031,2019,16995,16190,805,4.7
36033,2019,19614,18648,966,4.9
36035,2019,22656,21517,1139,5
36037,2019,29736,28564,1172,3.9
36039,2019,20271,19358,913,4.5
36041,2019,2214,2081,133,6
36043,2019,27932,26560,1372,4.9
36045,2019,43941,41470,2471,5.6
36047,2019,1198160,1149461,48699,4.1
36049,2019,11644,10999,645,5.5
36051,2019,30726,29423,1303,4.2
36053,2019,32766,31296,1470,4.5
36055,2019,361254,346207,15047,4.2
36057,2019,22306,21173,1133,5.1
36059,2019,708118,683726,24392,3.4
36061,2019,911638,879665,31973,3.5
36063,2019,98786,93887,4899,5
36065,2019,101170,96839,4331,4.3
36067,2019,220549,211875,8674,3.9
36069,2019,55362,53210,2152,3.9
36071,2019,184985,177952,7033,3.8
36073,2019,17567,16740,827,4.7
36075,2019,52960,50082,2878,5.4
36077,2019,28060,26876,1184,4.2
36079,2019,51230,49336,1894,3.7
36081,2019,1139397,1099996,39401,3.5
36083,2019,81089,78030,3059,3.8
36085,2019,222319,213734,8585,3.9
36087,2019,155237,149705,5532,3.6
36089,2019,43294,40902,2392,5.5
36091,2019,118925,114903,4022,3.4
36093,2019,76028,73106,2922,3.8
36095,2019,14637,13954,683,4.7
36097,2019,8085,7709,376,4.7
36099,2019,16027,15414,613,3.8
36101,2019,42520,40572,1948,4.6
36103,2019,778193,749347,28846,3.7
36105,2019,36653,35205,1448,4
36107,2019,22687,21746,941,4.1
36109,2019,49361,47567,1794,3.6
36111,2019,87692,84387,3305,3.8
36113,2019,31299,29868,1431,4.6
36115,2019,27831,26698,1133,4.1
36117,2019,43835,42070,1765,4
36119,2019,484382,466158,18224,3.8
36121,2019,18131,17336,795,4.4
36123,2019,11849,11407,442,3.7
37001,2019,82597,79459,3138,3.8
37003,2019,18159,17557,602,3.3
37005,2019,4415,4205,210,4.8
37007,2019,10834,10381,453,4.2
37009,2019,12908,12429,479,3.7
37011,2019,7502,7221,281,3.7
37013,2019,19578,18672,906,4.6
37015,2019,7822,7448,374,4.8
37017,2019,14629,13923,706,4.8
37019,2019,54411,51599,2812,5.2
37021,2019,141959,137723,4236,3
37023,2019,41324,39785,1539,3.7
37025,2019,109927,106011,3916,3.6
37027,2019,36866,35370,1496,4.1
37029,2019,4661,4481,180,3.9
37031,2019,32229,30889,1340,4.2
37033,2019,9924,9477,447,4.5
37035,2019,79540,76686,2854,3.6
37037,2019,35910,34695,1215,3.4
37039,2019,11226,10724,502,4.5
37041,2019,5560,5298,262,4.7
37043,2019,4148,3960,188,4.5
37045,2019,48738,46793,1945,4
37047,2019,22941,21811,1130,4.9
37049,2019,42150,40431,1719,4.1
37051,2019,128856,122306,6550,5.1
37053,2019,14117,13609,508,3.6
37055,2019,20063,19116,947,4.7
37057,2019,81755,78747,3008,3.7
37059,2019,20873,20161,712,3.4
37061,2019,25424,24394,1030,4.1
37063,2019,172359,166460,5899,3.4
37065,2019,21439,20179,1260,5.9
37067,2019,189793,182709,7084,3.7
37069,2019,31571,30309,1262,4
37071,2019,111967,107634,4333,3.9
37073,2019,5363,5145,218,4.1
37075,2019,3256,3080,176,5.4
37077,2019,30243,29219,1024,3.4
37079,2019,9577,9215,362,3.8
37081,2019,265349,254504,10845,4.1
37083,2019,20501,19326,1175,5.7
37085,2019,53705,51237,2468,4.6
37087,2019,30282,29255,1027,3.4
37089,2019,55704,53865,1839,3.3
37091,2019,9225,8746,479,5.2
37093,2019,20307,19304,1003,4.9
37095,2019,1977,1807,170,8.6
37097,2019,90208,86966,3242,3.6
37099,2019,19957,19130,827,4.1
37101,2019,99974,96347,3627,3.6
37103,2019,4436,4264,172,3.9
37105,2019,26174,24995,1179,4.5
37107,2019,28078,27012,1066,3.8
37109,2019,43826,42284,1542,3.5
37111,2019,20877,20075,802,3.8
37113,2019,15637,15027,610,3.9
37115,2019,10283,9909,374,3.6
37117,2019,9093,8630,463,5.1
37119,2019,626769,603983,22786,3.6
37121,2019,6073,5792,281,4.6
37123,2019,11606,11143,463,4
37125,2019,42887,41263,1624,3.8
37127,2019,43610,41511,2099,4.8
37129,2019,125131,120673,4458,3.6
37131,2019,7792,7386,406,5.2
37133,2019,65413,62388,3025,4.6
37135,2019,79385,76782,2603,3.3
37137,2019,5391,5186,205,3.8
37139,2019,16794,16021,773,4.6
37141,2019,29150,28001,1149,3.9
37143,2019,4992,4741,251,5
37145,2019,18571,17790,781,4.2
37147,2019,90556,86710,3846,4.2
37149,2019,9094,8748,346,3.8
37151,2019,66978,64451,2527,3.8
37153,2019,16727,15844,883,5.3
37155,2019,50481,47748,2733,5.4
37157,2019,40573,38791,1782,4.4
37159,2019,66751,64079,2672,4
37161,2019,25376,24131,1245,4.9
37163,2019,29437,28301,1136,3.9
37165,2019,11599,10832,767,6.6
37167,2019,30438,29309,1129,3.7
37169,2019,21936,21149,787,3.6
37171,2019,34200,32947,1253,3.7
37173,2019,7018,6737,281,4
37175,2019,14747,14196,551,3.7
37177,2019,1484,1396,88,5.9
37179,2019,124843,120533,4310,3.5
37181,2019,17501,16488,1013,5.8
37183,2019,600826,580731,20095,3.3
37185,2019,6638,6260,378,5.7
37187,2019,4492,4229,263,5.9
37189,2019,29679,28640,1039,3.5
37191,2019,52394,50225,2169,4.1
37193,2019,29489,28292,1197,4.1
37195,2019,35026,33002,2024,5.8
37197,2019,17923,17307,616,3.4
37199,2019,8466,8148,318,3.8
38001,2019,1046,1023,23,2.2
38003,2019,5143,4987,156,3
38005,2019,2273,2177,96,4.2
38007,2019,430,419,11,2.6
38009,2019,2935,2838,97,3.3
38011,2019,1714,1686,28,1.6
38013,2019,1053,1029,24,2.3
38015,2019,49216,48036,1180,2.4
38017,2019,102347,100269,2078,2
38019,2019,1882,1830,52,2.8
38021,2019,2281,2238,43,1.9
38023,2019,1439,1419,20,1.4
38025,2019,3153,3102,51,1.6
38027,2019,1213,1159,54,4.5
38029,2019,1428,1369,59,4.1
38031,2019,1497,1456,41,2.7
38033,2019,830,815,15,1.8
38035,2019,37105,36332,773,2.1
38037,2019,1179,1152,27,2.3
38039,2019,1013,988,25,2.5
38041,2019,1361,1334,27,2
38043,2019,1247,1197,50,4
38045,2019,2036,1993,43,2.1
38047,2019,860,840,20,2.3
38049,2019,3030,2924,106,3.5
38051,2019,1104,1071,33,3
38053,2019,10298,10138,160,1.6
38055,2019,4663,4516,147,3.2
38057,2019,3577,3427,150,4.2
38059,2019,16191,15713,478,3
38061,2019,7312,7211,101,1.4
38063,2019,1373,1330,43,3.1
38065,2019,861,829,32,3.7
38067,2019,3303,3189,114,3.5
38069,2019,1706,1651,55,3.2
38071,2019,5551,5388,163,2.9
38073,2019,2789,2741,48,1.7
38075,2019,1203,1173,30,2.5
38077,2019,8530,8330,200,2.3
38079,2019,4568,4192,376,8.199999999999999
38081,2019,2634,2587,47,1.8
38083,2019,671,642,29,4.3
38085,2019,1233,1185,48,3.9
38087,2019,393,384,9,2.3
38089,2019,18461,18087,374,2
38091,2019,967,947,20,2.1
38093,2019,10224,9989,235,2.3
38095,2019,1121,1090,31,2.8
38097,2019,4338,4224,114,2.6
38099,2019,5109,4942,167,3.3
38101,2019,31394,30614,780,2.5
38103,2019,1890,1832,58,3.1
38105,2019,24427,23989,438,1.8
39001,2019,10717,9984,733,6.8
39003,2019,47866,45937,1929,4
39005,2019,26801,25687,1114,4.2
39007,2019,44459,42334,2125,4.8
39009,2019,27694,26226,1468,5.3
39011,2019,24980,24230,750,3
39013,2019,30153,28469,1684,5.6
39015,2019,19594,18619,975,5
39017,2019,195091,187729,7362,3.8
39019,2019,12959,12317,642,5
39021,2019,20033,19295,738,3.7
39023,2019,63253,60520,2733,4.3
39025,2019,106832,102846,3986,3.7
39027,2019,17682,16849,833,4.7
39029,2019,47395,45105,2290,4.8
39031,2019,14377,13536,841,5.8
39033,2019,18208,17356,852,4.7
39035,2019,614517,588912,25605,4.2
39037,2019,25812,24863,949,3.7
39039,2019,18085,17322,763,4.2
39041,2019,110349,106887,3462,3.1
39043,2019,37223,35383,1840,4.9
39045,2019,78021,75118,2903,3.7
39047,2019,13869,13330,539,3.9
39049,2019,697639,673069,24570,3.5
39051,2019,22455,21526,929,4.1
39053,2019,12158,11496,662,5.4
39055,2019,49294,47586,1708,3.5
39057,2019,83246,80130,3116,3.7
39059,2019,18623,17607,1016,5.5
39061,2019,416102,400359,15743,3.8
39063,2019,41849,40525,1324,3.2
39065,2019,13812,13232,580,4.2
39067,2019,6800,6443,357,5.3
39069,2019,13265,12654,611,4.6
39071,2019,17036,16155,881,5.2
39073,2019,13084,12484,600,4.6
39075,2019,20783,20160,623,3
39077,2019,27985,26381,1604,5.7
39079,2019,12678,11891,787,6.2
39081,2019,27729,26101,1628,5.9
39083,2019,31550,30306,1244,3.9
39085,2019,126718,122045,4673,3.7
39087,2019,23780,22549,1231,5.2
39089,2019,90521,87159,3362,3.7
39091,2019,22865,22036,829,3.6
39093,2019,154180,147587,6593,4.3
39095,2019,210209,200417,9792,4.7
39097,2019,20804,20091,713,3.4
39099,2019,103081,97180,5901,5.7
39101,2019,28444,27292,1152,4.1
39103,2019,97857,94520,3337,3.4
39105,2019,9057,8428,629,6.9
39107,2019,23398,22787,611,2.6
39109,2019,54117,52125,1992,3.7
39111,2019,5345,4903,442,8.300000000000001
39113,2019,252534,241945,10589,4.2
39115,2019,6714,6280,434,6.5
39117,2019,16815,16124,691,4.1
39119,2019,39532,37592,1940,4.9
39121,2019,4699,4377,322,6.9
39123,2019,21050,19862,1188,5.6
39125,2019,8628,8297,331,3.8
39127,2019,15914,15087,827,5.2
39129,2019,26460,25404,1056,4
39131,2019,10824,10155,669,6.2
39133,2019,87309,83621,3688,4.2
39135,2019,21136,20342,794,3.8
39137,2019,18817,18235,582,3.1
39139,2019,52246,49884,2362,4.5
39141,2019,35318,33829,1489,4.2
39143,2019,30506,29193,1313,4.3
39145,2019,28862,27056,1806,6.3
39147,2019,27313,26184,1129,4.1
39149,2019,24178,23325,853,3.5
39151,2019,185736,177352,8384,4.5
39153,2019,272341,260690,11651,4.3
39155,2019,86758,81440,5318,6.1
39157,2019,44840,42908,1932,4.3
39159,2019,28974,28041,933,3.2
39161,2019,15054,14563,491,3.3
39163,2019,5560,5246,314,5.6
39165,2019,119179,115000,4179,3.5
39167,2019,27390,25918,1472,5.4
39169,2019,62073,60061,2012,3.2
39171,2019,18992,18363,629,3.3
39173,2019,71161,68553,2608,3.7
39175,2019,12975,12569,406,3.1
40001,2019,8061,7726,335,4.2
40003,2019,2819,2761,58,2.1
40005,2019,4920,4706,214,4.3
40007,2019,2876,2819,57,2
40009,2019,10494,10162,332,3.2
40011,2019,4750,4655,95,2
40013,2019,21334,20684,650,3
40015,2019,11768,11346,422,3.6
40017,2019,74245,72123,2122,2.9
40019,2019,21512,20772,740,3.4
40021,2019,18737,17989,748,4
40023,2019,5428,5166,262,4.8
40025,2019,1324,1301,23,1.7
40027,2019,142822,138776,4046,2.8
40029,2019,2480,2383,97,3.9
40031,2019,48157,46396,1761,3.7
40033,2019,2718,2632,86,3.2
40035,2019,5926,5715,211,3.6
40037,2019,31636,30465,1171,3.7
40039,2019,15675,15279,396,2.5
40041,2019,17990,17304,686,3.8
40043,2019,2891,2829,62,2.1
40045,2019,2156,2102,54,2.5
40047,2019,27069,26255,814,3
40049,2019,12576,12174,402,3.2
40051,2019,26474,25657,817,3.1
40053,2019,2650,2594,56,2.1
40055,2019,1836,1758,78,4.2
40057,2019,1174,1140,34,2.9
40059,2019,1748,1697,51,2.9
40061,2019,4217,3994,223,5.3
40063,2019,5316,5057,259,4.9
40065,2019,10650,10337,313,2.9
40067,2019,2506,2425,81,3.2
40069,2019,3755,3593,162,4.3
40071,2019,18307,17526,781,4.3
40073,2019,9142,8955,187,2
40075,2019,3453,3323,130,3.8
40077,2019,3135,2937,198,6.3
40079,2019,19035,18141,894,4.7
40081,2019,15776,15219,557,3.5
40083,2019,22081,21445,636,2.9
40085,2019,6170,6030,140,2.3
40087,2019,19628,19092,536,2.7
40089,2019,14383,13570,813,5.7
40091,2019,7067,6654,413,5.8
40093,2019,3871,3788,83,2.1
40095,2019,6880,6642,238,3.5
40097,2019,19411,18802,609,3.1
40099,2019,6307,6117,190,3
40101,2019,29568,28418,1150,3.9
40103,2019,5669,5530,139,2.5
40105,2019,4593,4434,159,3.5
40107,2019,4614,4402,212,4.6
40109,2019,384731,372632,12099,3.1
40111,2019,15712,14943,769,4.9
40113,2019,20704,19921,783,3.8
40115,2019,14077,13599,478,3.4
40117,2019,7363,7074,289,3.9
40119,2019,37930,36836,1094,2.9
40121,2019,17129,16406,723,4.2
40123,2019,19044,18451,593,3.1
40125,2019,32342,31169,1173,3.6
40127,2019,4278,4066,212,5
40129,2019,1878,1822,56,3
40131,2019,45151,43759,1392,3.1
40133,2019,9434,8979,455,4.8
40135,2019,16168,15502,666,4.1
40137,2019,18536,17737,799,4.3
40139,2019,11189,10969,220,2
40141,2019,2989,2879,110,3.7
40143,2019,323670,313397,10273,3.2
40145,2019,37999,36806,1193,3.1
40147,2019,22310,21547,763,3.4
40149,2019,5203,5028,175,3.4
40151,2019,4601,4505,96,2.1
40153,2019,8988,8727,261,2.9
41001,2019,7120,6789,331,4.6
41003,2019,48151,46736,1415,2.9
41005,2019,219468,212043,7425,3.4
41007,2019,19385,18659,726,3.7
41009,2019,24437,23340,1097,4.5
41011,2019,26147,24874,1273,4.9
41013,2019,9593,9083,510,5.3
41015,2019,8895,8432,463,5.2
41017,2019,96093,92361,3732,3.9
41019,2019,46339,44063,2276,4.9
41021,2019,947,912,35,3.7
41023,2019,3185,2964,221,6.9
41025,2019,3577,3387,190,5.3
41027,2019,14470,14012,458,3.2
41029,2019,103451,98950,4501,4.4
41031,2019,10125,9613,512,5.1
41033,2019,35786,34004,1782,5
41035,2019,29291,27485,1806,6.2
41037,2019,3628,3433,195,5.4
41039,2019,180588,173271,7317,4.1
41041,2019,20848,19947,901,4.3
41043,2019,58720,56191,2529,4.3
41045,2019,12314,11804,510,4.1
41047,2019,161879,155513,6366,3.9
41049,2019,5712,5477,235,4.1
41051,2019,455189,440311,14878,3.3
41053,2019,39860,38240,1620,4.1
41055,2019,932,900,32,3.4
41057,2019,11879,11421,458,3.9
41059,2019,36779,35014,1765,4.8
41061,2019,11938,11362,576,4.8
41063,2019,3420,3221,199,5.8
41065,2019,13360,12809,551,4.1
41067,2019,325006,315008,9998,3.1
41069,2019,722,691,31,4.3
41071,2019,54839,52981,1858,3.4
42001,2019,55350,53531,1819,3.3
42003,2019,649873,623045,26828,4.1
42005,2019,32307,30671,1636,5.1
42007,2019,84172,80367,3805,4.5
42009,2019,23622,22510,1112,4.7
42011,2019,216147,206763,9384,4.3
42013,2019,59551,56860,2691,4.5
42015,2019,28959,27697,1262,4.4
42017,2019,345279,332053,13226,3.8
42019,2019,99994,96090,3904,3.9
42021,2019,58064,54963,3101,5.3
42023,2019,2088,1963,125,6
42025,2019,32252,30516,1736,5.4
42027,2019,80144,77464,2680,3.3
42029,2019,286480,277341,9139,3.2
42031,2019,17131,16289,842,4.9
42033,2019,35987,34114,1873,5.2
42035,2019,18338,17347,991,5.4
42037,2019,33552,31955,1597,4.8
42039,2019,38685,36853,1832,4.7
42041,2019,132626,128165,4461,3.4
42043,2019,144836,139003,5833,4
42045,2019,299802,287670,12132,4
42047,2019,15677,14911,766,4.9
42049,2019,128841,122943,5898,4.6
42051,2019,57273,53868,3405,5.9
42053,2019,1818,1694,124,6.8
42055,2019,77887,74904,2983,3.8
42057,2019,7907,7560,347,4.4
42059,2019,16626,15771,855,5.1
42061,2019,20012,18833,1179,5.9
42063,2019,39155,37186,1969,5
42065,2019,20587,19612,975,4.7
42067,2019,12616,12061,555,4.4
42069,2019,105216,100057,5159,4.9
42071,2019,285253,275432,9821,3.4
42073,2019,40775,38687,2088,5.1
42075,2019,72617,69798,2819,3.9
42077,2019,193388,184665,8723,4.5
42079,2019,157695,148722,8973,5.7
42081,2019,56919,54169,2750,4.8
42083,2019,17355,16435,920,5.3
42085,2019,49321,46909,2412,4.9
42087,2019,21076,20093,983,4.7
42089,2019,83291,78812,4479,5.4
42091,2019,456383,440364,16019,3.5
42093,2019,9122,8795,327,3.6
42095,2019,161856,154642,7214,4.5
42097,2019,43184,40765,2419,5.6
42099,2019,24583,23673,910,3.7
42101,2019,722078,682012,40066,5.5
42103,2019,25321,23909,1412,5.6
42105,2019,7209,6784,425,5.9
42107,2019,66554,62948,3606,5.4
42109,2019,20172,19079,1093,5.4
42111,2019,33659,31869,1790,5.3
42113,2019,2671,2531,140,5.2
42115,2019,20606,19717,889,4.3
42117,2019,19148,18139,1009,5.3
42119,2019,19912,19114,798,4
42121,2019,22444,21354,1090,4.9
42123,2019,18977,18116,861,4.5
42125,2019,107299,102475,4824,4.5
42127,2019,22486,21427,1059,4.7
42129,2019,181453,173320,8133,4.5
42131,2019,13610,12948,662,4.9
42133,2019,236377,227297,9080,3.8
44001,2019,26005,25226,779,3
44003,2019,90729,87815,2914,3.2
44005,2019,44280,42905,1375,3.1
44007,2019,325490,312930,12560,3.9
44009,2019,69050,66892,2158,3.1
45001,2019,10050,9711,339,3.4
45003,2019,75105,72929,2176,2.9
45005,2019,2692,2549,143,5.3
45007,2019,91576,89109,2467,2.7
45009,2019,4981,4704,277,5.6
45011,2019,8268,7916,352,4.3
45013,2019,77858,75797,2061,2.6
45015,2019,104452,101801,2651,2.5
45017,2019,6604,6367,237,3.6
45019,2019,212354,207473,4881,2.3
45021,2019,25196,24422,774,3.1
45023,2019,13445,12890,555,4.1
45025,2019,22128,21484,644,2.9
45027,2019,12731,12238,493,3.9
45029,2019,16821,16283,538,3.2
45031,2019,30561,29518,1043,3.4
45033,2019,13029,12496,533,4.1
45035,2019,78453,76502,1951,2.5
45037,2019,10753,10452,301,2.8
45039,2019,9619,9192,427,4.4
45041,2019,67211,65235,1976,2.9
45043,2019,25790,24820,970,3.8
45045,2019,255903,249678,6225,2.4
45047,2019,31377,30397,980,3.1
45049,2019,8416,8187,229,2.7
45051,2019,148573,143234,5339,3.6
45053,2019,12685,12363,322,2.5
45055,2019,29291,28425,866,3
45057,2019,41340,39956,1384,3.3
45059,2019,30313,29410,903,3
45061,2019,6618,6352,266,4
45063,2019,150160,146650,3510,2.3
45065,2019,3389,3285,104,3.1
45067,2019,13045,12481,564,4.3
45069,2019,9183,8739,444,4.8
45071,2019,19223,18709,514,2.7
45073,2019,35039,34068,971,2.8
45075,2019,34842,33187,1655,4.8
45077,2019,57667,56063,1604,2.8
45079,2019,198948,193369,5579,2.8
45081,2019,8928,8690,238,2.7
45083,2019,153496,149576,3920,2.6
45085,2019,43727,42254,1473,3.4
45087,2019,11681,11275,406,3.5
45089,2019,12093,11542,551,4.6
45091,2019,140458,136587,3871,2.8
46003,2019,1527,1485,42,2.8
46005,2019,9618,9315,303,3.2
46007,2019,1091,1032,59,5.4
46009,2019,2870,2779,91,3.2
46011,2019,19138,18511,627,3.3
46013,2019,20795,20152,643,3.1
46015,2019,2451,2375,76,3.1
46017,2019,683,638,45,6.6
46019,2019,5044,4873,171,3.4
46021,2019,772,744,28,3.6
46023,2019,3763,3622,141,3.7
46025,2019,1913,1836,77,4
46027,2019,7432,7184,248,3.3
46029,2019,15518,15028,490,3.2
46031,2019,1368,1289,79,5.8
46033,2019,4009,3831,178,4.4
46035,2019,11103,10778,325,2.9
46037,2019,2763,2637,126,4.6
46039,2019,2172,2067,105,4.8
46041,2019,2228,2044,184,8.300000000000001
46043,2019,1584,1539,45,2.8
46045,2019,2041,1980,61,3
46047,2019,2992,2864,128,4.3
46049,2019,1058,1023,35,3.3
46051,2019,4443,4293,150,3.4
46053,2019,2048,1977,71,3.5
46055,2019,1051,1020,31,2.9
46057,2019,3319,3210,109,3.3
46059,2019,1783,1733,50,2.8
46061,2019,1745,1663,82,4.7
46063,2019,725,705,20,2.8
46065,2019,10039,9771,268,2.7
46067,2019,3598,3486,112,3.1
46069,2019,682,658,24,3.5
46071,2019,1272,1199,73,5.7
46073,2019,1117,1086,31,2.8
46075,2019,544,527,17,3.1
46077,2019,2671,2590,81,3
46079,2019,6684,6443,241,3.6
46081,2019,13343,12915,428,3.2
46083,2019,34595,33709,886,2.6
46085,2019,1690,1609,81,4.8
46087,2019,3078,2990,88,2.9
46089,2019,1006,963,43,4.3
46091,2019,2383,2292,91,3.8
46093,2019,14138,13632,506,3.6
46095,2019,741,699,42,5.7
46097,2019,1177,1140,37,3.1
46099,2019,113094,109853,3241,2.9
46101,2019,4041,3895,146,3.6
46102,2019,3570,3222,348,9.699999999999999
46103,2019,56757,54827,1930,3.4
46105,2019,1425,1381,44,3.1
46107,2019,1045,1012,33,3.2
46109,2019,4839,4630,209,4.3
46111,2019,1153,1117,36,3.1
46115,2019,3189,3080,109,3.4
46117,2019,1850,1795,55,3
46119,2019,800,777,23,2.9
46121,2019,3166,2961,205,6.5
46123,2019,3070,2981,89,2.9
46125,2019,4702,4559,143,3
46127,2019,8484,8192,292,3.4
46129,2019,2125,2008,117,5.5
46135,2019,11958,11615,343,2.9
46137,2019,930,878,52,5.6
47001,2019,34949,33708,1241,3.6
47003,2019,21223,20437,786,3.7
47005,2019,6964,6653,311,4.5
47007,2019,4346,4111,235,5.4
47009,2019,64115,62072,2043,3.2
47011,2019,52465,50654,1811,3.5
47013,2019,14978,14291,687,4.6
47015,2019,6686,6481,205,3.1
47017,2019,12172,11582,590,4.8
47019,2019,24218,23235,983,4.1
47021,2019,22186,21606,580,2.6
47023,2019,8640,8343,297,3.4
47025,2019,13178,12624,554,4.2
47027,2019,2808,2640,168,6
47029,2019,15164,14477,687,4.5
47031,2019,25749,24891,858,3.3
47033,2019,7069,6823,246,3.5
47035,2019,23685,22624,1061,4.5
47037,2019,409810,399502,10308,2.5
47039,2019,4611,4366,245,5.3
47041,2019,7855,7516,339,4.3
47043,2019,27409,26593,816,3
47045,2019,16597,15792,805,4.9
47047,2019,19370,18663,707,3.6
47049,2019,7555,7240,315,4.2
47051,2019,20343,19663,680,3.3
47053,2019,22262,21320,942,4.2
47055,2019,15126,14543,583,3.9
47057,2019,9608,9221,387,4
47059,2019,29995,28599,1396,4.7
47061,2019,5017,4809,208,4.1
47063,2019,28385,27292,1093,3.9
47065,2019,185402,179393,6009,3.2
47067,2019,2130,2005,125,5.9
47069,2019,9576,9099,477,5
47071,2019,10486,10038,448,4.3
47073,2019,23986,22998,988,4.1
47075,2019,7749,7373,376,4.9
47077,2019,12369,11832,537,4.3
47079,2019,14321,13727,594,4.1
47081,2019,11599,11243,356,3.1
47083,2019,3297,3146,151,4.6
47085,2019,9025,8678,347,3.8
47087,2019,4702,4486,216,4.6
47089,2019,24800,23882,918,3.7
47091,2019,7730,7462,268,3.5
47093,2019,246227,239090,7137,2.9
47095,2019,1779,1678,101,5.7
47097,2019,9794,9262,532,5.4
47099,2019,19432,18640,792,4.1
47101,2019,5221,5010,211,4
47103,2019,16900,16295,605,3.6
47105,2019,23696,22895,801,3.4
47107,2019,23880,22978,902,3.8
47109,2019,8580,8130,450,5.2
47111,2019,11435,11079,356,3.1
47113,2019,49493,47727,1766,3.6
47115,2019,12598,12057,541,4.3
47117,2019,15860,15305,555,3.5
47119,2019,50157,48575,1582,3.2
47121,2019,5230,4992,238,4.6
47123,2019,20356,19613,743,3.7
47125,2019,86220,82946,3274,3.8
47127,2019,3635,3529,106,2.9
47129,2019,7956,7632,324,4.1
47131,2019,12615,11999,616,4.9
47133,2019,10026,9647,379,3.8
47135,2019,3146,2988,158,5
47137,2019,2385,2274,111,4.7
47139,2019,7576,7274,302,4
47141,2019,35355,34124,1231,3.5
47143,2019,13401,12636,765,5.7
47145,2019,23617,22662,955,4
47147,2019,38549,37440,1109,2.9
47149,2019,186696,181904,4792,2.6
47151,2019,8427,8059,368,4.4
47153,2019,6250,5987,263,4.2
47155,2019,55225,53420,1805,3.3
47157,2019,449965,431885,18080,4
47159,2019,9589,9301,288,3
47161,2019,5540,5292,248,4.5
47163,2019,70979,68347,2632,3.7
47165,2019,103810,101033,2777,2.7
47167,2019,28461,27356,1105,3.9
47169,2019,5503,5335,168,3.1
47171,2019,7167,6809,358,5
47173,2019,7698,7387,311,4
47175,2019,2072,1979,93,4.5
47177,2019,16869,16178,691,4.1
47179,2019,60904,58800,2104,3.5
47181,2019,6301,6007,294,4.7
47183,2019,16267,15610,657,4
47185,2019,12363,11908,455,3.7
47187,2019,130215,127057,3158,2.4
47189,2019,77728,75639,2089,2.7
48001,2019,23913,23220,693,2.9
48003,2019,9906,9685,221,2.2
48005,2019,35893,34453,1440,4
48007,2019,9425,9022,403,4.3
48009,2019,4145,4027,118,2.8
48011,2019,929,904,25,2.7
48013,2019,21707,20928,779,3.6
48015,2019,14096,13613,483,3.4
48017,2019,2508,2415,93,3.7
48019,2019,10071,9742,329,3.3
48021,2019,42900,41609,1291,3
48023,2019,1765,1725,40,2.3
48025,2019,9853,9419,434,4.4
48027,2019,143858,138392,5466,3.8
48029,2019,949380,919763,29617,3.1
48031,2019,6469,6311,158,2.4
48033,2019,404,394,10,2.5
48035,2019,8343,8058,285,3.4
48037,2019,39899,38130,1769,4.4
48039,2019,179539,172008,7531,4.2
48041,2019,119010,115819,3191,2.7
48043,2019,4207,4084,123,2.9
48045,2019,578,558,20,3.5
48047,2019,2602,2468,134,5.1
48049,2019,15701,15117,584,3.7
48051,2019,8362,8103,259,3.1
48053,2019,23570,22930,640,2.7
48055,2019,19669,19011,658,3.3
48057,2019,12168,11776,392,3.2
48059,2019,6113,5925,188,3.1
48061,2019,166861,157675,9186,5.5
48063,2019,4975,4766,209,4.2
48065,2019,3011,2933,78,2.6
48067,2019,12430,11895,535,4.3
48069,2019,3433,3337,96,2.8
48071,2019,19489,18604,885,4.5
48073,2019,20936,20143,793,3.8
48075,2019,2952,2872,80,2.7
48077,2019,4936,4785,151,3.1
48079,2019,1123,1085,38,3.4
48081,2019,1456,1409,47,3.2
48083,2019,2888,2770,118,4.1
48085,2019,563678,546320,17358,3.1
48087,2019,1157,1120,37,3.2
48089,2019,9860,9557,303,3.1
48091,2019,73333,71149,2184,3
48093,2019,5591,5410,181,3.2
48095,2019,1238,1198,40,3.2
48097,2019,19820,19268,552,2.8
48099,2019,24123,23177,946,3.9
48101,2019,551,528,23,4.2
48103,2019,1569,1506,63,4
48105,2019,1637,1589,48,2.9
48107,2019,2499,2402,97,3.9
48109,2019,1044,1002,42,4
48111,2019,3918,3842,76,1.9
48113,2019,1364652,1317507,47145,3.5
48115,2019,4642,4462,180,3.9
48117,2019,8470,8237,233,2.8
48119,2019,2443,2360,83,3.4
48121,2019,494624,480005,14619,3
48123,2019,9798,9540,258,2.6
48125,2019,682,652,30,4.4
48127,2019,7487,7298,189,2.5
48129,2019,1439,1389,50,3.5
48131,2019,4966,4744,222,4.5
48133,2019,8354,8079,275,3.3
48135,2019,88186,85859,2327,2.6
48137,2019,1054,1030,24,2.3
48139,2019,92694,89823,2871,3.1
48141,2019,362582,348712,13870,3.8
48143,2019,20850,20188,662,3.2
48145,2019,6570,6356,214,3.3
48147,2019,17329,16854,475,2.7
48149,2019,12313,11987,326,2.6
48151,2019,1634,1586,48,2.9
48153,2019,2580,2468,112,4.3
48155,2019,585,567,18,3.1
48157,2019,392275,378653,13622,3.5
48159,2019,4654,4485,169,3.6
48161,2019,6400,6093,307,4.8
48163,2019,10463,10192,271,2.6
48165,2019,9812,9577,235,2.4
48167,2019,165479,158807,6672,4
48169,2019,2176,2117,59,2.7
48171,2019,13542,13213,329,2.4
48173,2019,795,778,17,2.1
48175,2019,3272,3162,110,3.4
48177,2019,9578,9320,258,2.7
48179,2019,8080,7791,289,3.6
48181,2019,64106,62148,1958,3.1
48183,2019,58349,56176,2173,3.7
48185,2019,11264,10822,442,3.9
48187,2019,81486,79087,2399,2.9
48189,2019,12210,11663,547,4.5
48191,2019,1073,1029,44,4.1
48193,2019,3672,3561,111,3
48195,2019,2779,2714,65,2.3
48197,2019,1722,1670,52,3
48199,2019,25321,24158,1163,4.6
48201,2019,2317346,2228703,88643,3.8
48203,2019,29485,28306,1179,4
48205,2019,2802,2756,46,1.6
48207,2019,2285,2210,75,3.3
48209,2019,119874,116574,3300,2.8
48211,2019,1937,1884,53,2.7
48213,2019,36518,35239,1279,3.5
48215,2019,352815,330817,21998,6.2
48217,2019,16409,15867,542,3.3
48219,2019,11290,10956,334,3
48221,2019,27560,26625,935,3.4
48223,2019,17544,17008,536,3.1
48225,2019,10364,10039,325,3.1
48227,2019,14040,13604,436,3.1
48229,2019,1827,1747,80,4.4
48231,2019,43412,41871,1541,3.5
48233,2019,8701,8315,386,4.4
48235,2019,761,743,18,2.4
48237,2019,3471,3362,109,3.1
48239,2019,7588,7360,228,3
48241,2019,12869,12083,786,6.1
48243,2019,1040,1010,30,2.9
48245,2019,106962,100737,6225,5.8
48247,2019,1884,1794,90,4.8
48249,2019,16852,16054,798,4.7
48251,2019,82176,79532,2644,3.2
48253,2019,5738,5494,244,4.3
48255,2019,7187,7008,179,2.5
48257,2019,64597,62485,2112,3.3
48259,2019,22132,21533,599,2.7
48261,2019,223,215,8,3.6
48263,2019,478,467,11,2.3
48265,2019,22251,21593,658,3
48267,2019,1862,1805,57,3.1
48269,2019,233,228,5,2.1
48271,2019,1377,1327,50,3.6
48273,2019,13496,12908,588,4.4
48275,2019,1444,1397,47,3.3
48277,2019,24052,23241,811,3.4
48279,2019,5311,5108,203,3.8
48281,2019,9212,8910,302,3.3
48283,2019,4401,4295,106,2.4
48285,2019,8590,8333,257,3
48287,2019,10120,9852,268,2.6
48289,2019,6325,6049,276,4.4
48291,2019,33101,31432,1669,5
48293,2019,8593,8260,333,3.9
48295,2019,1650,1607,43,2.6
48297,2019,5564,5392,172,3.1
48299,2019,8679,8380,299,3.4
48301,2019,542,538,4,.7
48303,2019,158134,153680,4454,2.8
48305,2019,2775,2693,82,3
48307,2019,3488,3307,181,5.2
48309,2019,119629,115668,3961,3.3
48311,2019,821,808,13,1.6
48313,2019,4555,4361,194,4.3
48315,2019,4239,4058,181,4.3
48317,2019,2889,2814,75,2.6
48319,2019,1772,1715,57,3.2
48321,2019,16712,15766,946,5.7
48323,2019,23803,22013,1790,7.5
48325,2019,21828,21142,686,3.1
48327,2019,862,832,30,3.5
48329,2019,107495,105290,2205,2.1
48331,2019,9788,9301,487,5
48333,2019,1904,1842,62,3.3
48335,2019,2325,2243,82,3.5
48337,2019,9323,9058,265,2.8
48339,2019,284078,274419,9659,3.4
48341,2019,10915,10660,255,2.3
48343,2019,4808,4552,256,5.3
48345,2019,483,466,17,3.5
48347,2019,28210,27153,1057,3.7
48349,2019,24061,23283,778,3.2
48351,2019,5182,4858,324,6.3
48353,2019,7066,6860,206,2.9
48355,2019,167411,160536,6875,4.1
48357,2019,4330,4213,117,2.7
48359,2019,916,890,26,2.8
48361,2019,36395,34518,1877,5.2
48363,2019,13602,13175,427,3.1
48365,2019,10208,9799,409,4
48367,2019,67332,65373,1959,2.9
48369,2019,4897,4787,110,2.2
48371,2019,6397,6188,209,3.3
48373,2019,18023,17171,852,4.7
48375,2019,55183,53668,1515,2.7
48377,2019,3104,2902,202,6.5
48379,2019,6044,5862,182,3
48381,2019,72066,70315,1751,2.4
48383,2019,1909,1861,48,2.5
48385,2019,1062,1020,42,4
48387,2019,5108,4873,235,4.6
48389,2019,11403,11209,194,1.7
48391,2019,3154,3036,118,3.7
48393,2019,418,405,13,3.1
48395,2019,7656,7383,273,3.6
48397,2019,52083,50482,1601,3.1
48399,2019,4604,4475,129,2.8
48401,2019,23074,22251,823,3.6
48403,2019,3737,3490,247,6.6
48405,2019,3402,3240,162,4.8
48407,2019,11749,11211,538,4.6
48409,2019,29906,28278,1628,5.4
48411,2019,2569,2494,75,2.9
48413,2019,1323,1285,38,2.9
48415,2019,6736,6518,218,3.2
48417,2019,1910,1868,42,2.2
48419,2019,11178,10738,440,3.9
48421,2019,1379,1347,32,2.3
48423,2019,107171,103584,3587,3.3
48425,2019,4364,4209,155,3.6
48427,2019,25227,22745,2482,9.800000000000001
48429,2019,4109,3983,126,3.1
48431,2019,579,561,18,3.1
48433,2019,588,571,17,2.9
48435,2019,1414,1361,53,3.7
48437,2019,2628,2531,97,3.7
48439,2019,1082571,1046916,35655,3.3
48441,2019,66926,65005,1921,2.9
48443,2019,377,364,13,3.4
48445,2019,5006,4823,183,3.7
48447,2019,656,631,25,3.8
48449,2019,12976,12435,541,4.2
48451,2019,54568,52917,1651,3
48453,2019,741101,722054,19047,2.6
48455,2019,5317,5064,253,4.8
48457,2019,7156,6744,412,5.8
48459,2019,17914,17251,663,3.7
48461,2019,1675,1626,49,2.9
48463,2019,11501,11065,436,3.8
48465,2019,22932,22162,770,3.4
48467,2019,26082,25233,849,3.3
48469,2019,42854,41380,1474,3.4
48471,2019,24150,23214,936,3.9
48473,2019,23475,22597,878,3.7
48475,2019,7488,7316,172,2.3
48477,2019,15155,14656,499,3.3
48479,2019,118626,114247,4379,3.7
48481,2019,21670,20935,735,3.4
48483,2019,2279,2210,69,3
48485,2019,56362,54574,1788,3.2
48487,2019,4975,4798,177,3.6
48489,2019,6592,6052,540,8.199999999999999
48491,2019,313899,305127,8772,2.8
48493,2019,24876,24174,702,2.8
48495,2019,4026,3913,113,2.8
48497,2019,31891,30864,1027,3.2
48499,2019,17693,17008,685,3.9
48501,2019,3750,3641,109,2.9
48503,2019,8040,7802,238,3
48505,2019,5045,4787,258,5.1
48507,2019,3334,3050,284,8.5
49001,2019,2869,2783,86,3
49003,2019,25904,25222,682,2.6
49005,2019,64176,62779,1397,2.2
49007,2019,8517,8202,315,3.7
49009,2019,393,378,15,3.8
49011,2019,173800,169589,4211,2.4
49013,2019,7762,7457,305,3.9
49015,2019,4312,4139,173,4
49017,2019,2784,2611,173,6.2
49019,2019,6195,5953,242,3.9
49021,2019,24030,23326,704,2.9
49023,2019,5720,5576,144,2.5
49025,2019,3818,3707,111,2.9
49027,2019,5997,5832,165,2.8
49029,2019,5563,5428,135,2.4
49031,2019,482,459,23,4.8
49033,2019,1172,1136,36,3.1
49035,2019,634741,618767,15974,2.5
49037,2019,5725,5435,290,5.1
49039,2019,12479,12081,398,3.2
49041,2019,9741,9438,303,3.1
49043,2019,25039,24427,612,2.4
49045,2019,34002,33024,978,2.9
49047,2019,13671,13096,575,4.2
49049,2019,307609,300283,7326,2.4
49051,2019,16141,15705,436,2.7
49053,2019,76056,73806,2250,3
49055,2019,1417,1339,78,5.5
49057,2019,127579,123806,3773,3
50001,2019,20566,20091,475,2.3
50003,2019,18070,17539,531,2.9
50005,2019,14460,14030,430,3
50007,2019,96435,94707,1728,1.8
50009,2019,2682,2595,87,3.2
50011,2019,27313,26674,639,2.3
50013,2019,4041,3925,116,2.9
50015,2019,13888,13454,434,3.1
50017,2019,15905,15527,378,2.4
50019,2019,13275,12713,562,4.2
50021,2019,30446,29608,838,2.8
50023,2019,34360,33586,774,2.3
50025,2019,21977,21416,561,2.6
50027,2019,28809,28205,604,2.1
51001,2019,16708,16117,591,3.5
51003,2019,57688,56256,1432,2.5
51005,2019,6915,6677,238,3.4
51007,2019,6323,6123,200,3.2
51009,2019,15136,14651,485,3.2
51011,2019,7209,6959,250,3.5
51013,2019,155769,152803,2966,1.9
51015,2019,37722,36806,916,2.4
51017,2019,2509,2447,62,2.5
51019,2019,38712,37606,1106,2.9
51021,2019,2856,2777,79,2.8
51023,2019,17494,17049,445,2.5
51025,2019,6066,5781,285,4.7
51027,2019,6739,6359,380,5.6
51029,2019,6475,6206,269,4.2
51031,2019,26165,25349,816,3.1
51033,2019,15369,14879,490,3.2
51035,2019,13292,12818,474,3.6
51036,2019,3692,3566,126,3.4
51037,2019,5297,5109,188,3.5
51041,2019,189000,183821,5179,2.7
51043,2019,7665,7476,189,2.5
51045,2019,2312,2238,74,3.2
51047,2019,24818,24175,643,2.6
51049,2019,4664,4523,141,3
51051,2019,4731,4497,234,4.9
51053,2019,13769,13319,450,3.3
51057,2019,5526,5330,196,3.5
51059,2019,641034,626394,14640,2.3
51061,2019,37567,36655,912,2.4
51063,2019,8227,8014,213,2.6
51065,2019,14021,13698,323,2.3
51067,2019,26522,25742,780,2.9
51069,2019,48459,47290,1169,2.4
51071,2019,7927,7669,258,3.3
51073,2019,19705,19198,507,2.6
51075,2019,11302,10991,311,2.8
51077,2019,8053,7819,234,2.9
51079,2019,10578,10331,247,2.3
51081,2019,4307,4160,147,3.4
51083,2019,15682,15066,616,3.9
51085,2019,59705,58264,1441,2.4
51087,2019,183486,178372,5114,2.8
51089,2019,23868,23069,799,3.3
51091,2019,1248,1214,34,2.7
51093,2019,19570,19017,553,2.8
51095,2019,36841,35860,981,2.7
51097,2019,3871,3763,108,2.8
51099,2019,13515,13157,358,2.6
51101,2019,9228,8976,252,2.7
51103,2019,5464,5230,234,4.3
51105,2019,8306,7967,339,4.1
51107,2019,224573,219414,5159,2.3
51109,2019,20049,19517,532,2.7
51111,2019,5338,5169,169,3.2
51113,2019,7461,7295,166,2.2
51115,2019,4169,4048,121,2.9
51117,2019,12613,12105,508,4
51119,2019,5319,5181,138,2.6
51121,2019,50364,48937,1427,2.8
51125,2019,7508,7300,208,2.8
51127,2019,12577,12277,300,2.4
51131,2019,5485,5241,244,4.4
51133,2019,5704,5458,246,4.3
51135,2019,7298,7095,203,2.8
51137,2019,17480,16961,519,3
51139,2019,12065,11601,464,3.8
51141,2019,7342,7084,258,3.5
51143,2019,30210,29191,1019,3.4
51145,2019,14253,13892,361,2.5
51147,2019,10444,10051,393,3.8
51149,2019,15206,14695,511,3.4
51153,2019,247826,241558,6268,2.5
51155,2019,16149,15594,555,3.4
51157,2019,3727,3633,94,2.5
51159,2019,4097,3976,121,3
51161,2019,49611,48349,1262,2.5
51163,2019,10819,10523,296,2.7
51165,2019,42151,41146,1005,2.4
51167,2019,11227,10754,473,4.2
51169,2019,9149,8863,286,3.1
51171,2019,22426,21863,563,2.5
51173,2019,13811,13296,515,3.7
51175,2019,9139,8895,244,2.7
51177,2019,67663,65697,1966,2.9
51179,2019,72712,70711,2001,2.8
51181,2019,3695,3568,127,3.4
51183,2019,3833,3660,173,4.5
51185,2019,15748,15060,688,4.4
51187,2019,20611,20032,579,2.8
51191,2019,26806,25919,887,3.3
51193,2019,9538,9204,334,3.5
51195,2019,13432,12809,623,4.6
51197,2019,13776,13282,494,3.6
51199,2019,32989,32110,879,2.7
51510,2019,102254,100093,2161,2.1
51520,2019,7218,6946,272,3.8
51530,2019,3436,3342,94,2.7
51540,2019,26642,26011,631,2.4
51550,2019,123523,119957,3566,2.9
51570,2019,8877,8593,284,3.2
51580,2019,2393,2293,100,4.2
51590,2019,19226,18261,965,5
51595,2019,2303,2189,114,5
51600,2019,13573,13284,289,2.1
51610,2019,8676,8499,177,2
51620,2019,3598,3453,145,4
51630,2019,14282,13803,479,3.4
51640,2019,2932,2836,96,3.3
51650,2019,64807,62353,2454,3.8
51660,2019,25153,24345,808,3.2
51670,2019,9757,9341,416,4.3
51678,2019,2099,2001,98,4.7
51680,2019,36598,35238,1360,3.7
51683,2019,22253,21696,557,2.5
51685,2019,9462,9228,234,2.5
51690,2019,5501,5274,227,4.1
51700,2019,89406,86310,3096,3.5
51710,2019,112364,108487,3877,3.5
51720,2019,1687,1625,62,3.7
51730,2019,13129,12396,733,5.6
51735,2019,6427,6271,156,2.4
51740,2019,44566,42831,1735,3.9
51750,2019,8688,8377,311,3.6
51760,2019,119265,115360,3905,3.3
51770,2019,49397,47900,1497,3
51775,2019,13037,12677,360,2.8
51790,2019,12314,11986,328,2.7
51800,2019,44928,43564,1364,3
51810,2019,234597,228266,6331,2.7
51820,2019,10762,10451,311,2.9
51830,2019,6736,6475,261,3.9
51840,2019,14892,14480,412,2.8
53001,2019,9870,9312,558,5.7
53003,2019,10400,9969,431,4.1
53005,2019,103169,97773,5396,5.2
53007,2019,45113,42911,2202,4.9
53009,2019,28886,26980,1906,6.6
53011,2019,241901,230422,11479,4.7
53013,2019,1848,1747,101,5.5
53015,2019,47949,45086,2863,6
53017,2019,21968,20731,1237,5.6
53019,2019,2499,2216,283,11.3
53021,2019,43132,40383,2749,6.4
53023,2019,918,868,50,5.4
53025,2019,46990,43751,3239,6.9
53027,2019,29008,26961,2047,7.1
53029,2019,36116,34294,1822,5
53031,2019,12938,12209,729,5.6
53033,2019,1290480,1254638,35842,2.8
53035,2019,128764,122887,5877,4.6
53037,2019,23177,21905,1272,5.5
53039,2019,10314,9712,602,5.8
53041,2019,34996,32841,2155,6.2
53043,2019,5031,4779,252,5
53045,2019,25325,23733,1592,6.3
53047,2019,20346,18964,1382,6.8
53049,2019,8603,8007,596,6.9
53051,2019,5074,4674,400,7.9
53053,2019,442094,419394,22700,5.1
53055,2019,8674,8349,325,3.7
53057,2019,63069,59644,3425,5.4
53059,2019,5555,5252,303,5.5
53061,2019,439464,426100,13364,3
53063,2019,255027,241655,13372,5.2
53065,2019,19062,17726,1336,7
53067,2019,142896,135982,6914,4.8
53069,2019,1375,1283,92,6.7
53071,2019,30252,28760,1492,4.9
53073,2019,115413,109672,5741,5
53075,2019,23996,22958,1038,4.3
53077,2019,132466,123185,9281,7
54001,2019,7189,6760,429,6
54003,2019,58635,56569,2066,3.5
54005,2019,7443,7036,407,5.5
54007,2019,5245,4857,388,7.4
54009,2019,10013,9488,525,5.2
54011,2019,41620,39889,1731,4.2
54013,2019,2558,2226,332,13
54015,2019,3148,2879,269,8.5
54017,2019,4011,3834,177,4.4
54019,2019,16286,15363,923,5.7
54021,2019,2384,2221,163,6.8
54023,2019,5959,5632,327,5.5
54025,2019,16005,15266,739,4.6
54027,2019,10799,10384,415,3.8
54029,2019,13094,12418,676,5.2
54031,2019,5804,5507,297,5.1
54033,2019,34765,33229,1536,4.4
54035,2019,13478,12808,670,5
54037,2019,30464,29527,937,3.1
54039,2019,82440,78647,3793,4.6
54041,2019,6851,6428,423,6.2
54043,2019,7213,6757,456,6.3
54045,2019,11157,10492,665,6
54047,2019,4451,4041,410,9.199999999999999
54049,2019,25621,24324,1297,5.1
54051,2019,14268,13366,902,6.3
54053,2019,10227,9615,612,6
54055,2019,21036,19843,1193,5.7
54057,2019,12701,11980,721,5.7
54059,2019,6894,6422,472,6.8
54061,2019,54746,52749,1997,3.6
54063,2019,5979,5718,261,4.4
54065,2019,8191,7874,317,3.9
54067,2019,9521,8920,601,6.3
54069,2019,21367,20407,960,4.5
54071,2019,3701,3559,142,3.8
54073,2019,2924,2724,200,6.8
54075,2019,3891,3670,221,5.7
54077,2019,15617,14904,713,4.6
54079,2019,26795,25630,1165,4.3
54081,2019,30525,29093,1432,4.7
54083,2019,12352,11617,735,6
54085,2019,4405,4156,249,5.7
54087,2019,5145,4654,491,9.5
54089,2019,4340,4102,238,5.5
54091,2019,7920,7537,383,4.8
54093,2019,3361,3186,175,5.2
54095,2019,3145,2900,245,7.8
54097,2019,9613,9040,573,6
54099,2019,15838,14983,855,5.4
54101,2019,3326,3116,210,6.3
54103,2019,6656,6174,482,7.2
54105,2019,2303,2122,181,7.9
54107,2019,36845,34970,1875,5.1
54109,2019,6706,6240,466,6.9
55001,2019,8153,7733,420,5.2
55003,2019,7915,7536,379,4.8
55005,2019,24406,23428,978,4
55007,2019,7591,7165,426,5.6
55009,2019,141886,137489,4397,3.1
55011,2019,6466,6194,272,4.2
55013,2019,7133,6752,381,5.3
55015,2019,27565,26791,774,2.8
55017,2019,33181,31909,1272,3.8
55019,2019,17737,17151,586,3.3
55021,2019,31587,30606,981,3.1
55023,2019,7622,7297,325,4.3
55025,2019,321677,313824,7853,2.4
55027,2019,47544,46107,1437,3
55029,2019,15288,14706,582,3.8
55031,2019,23029,22058,971,4.2
55033,2019,24111,23257,854,3.5
55035,2019,58872,57071,1801,3.1
55037,2019,2221,2115,106,4.8
55039,2019,57386,55701,1685,2.9
55041,2019,4012,3803,209,5.2
55043,2019,27861,26962,899,3.2
55045,2019,21049,20441,608,2.9
55047,2019,9456,9086,370,3.9
55049,2019,13731,13334,397,2.9
55051,2019,2542,2388,154,6.1
55053,2019,10276,9876,400,3.9
55055,2019,45857,44416,1441,3.1
55057,2019,13446,12999,447,3.3
55059,2019,89403,85858,3545,4
55061,2019,11042,10686,356,3.2
55063,2019,66318,64391,1927,2.9
55065,2019,10099,9829,270,2.7
55067,2019,9321,8932,389,4.2
55069,2019,15071,14509,562,3.7
55071,2019,40987,39589,1398,3.4
55073,2019,73551,71419,2132,2.9
55075,2019,19466,18573,893,4.6
55077,2019,7714,7409,305,4
55078,2019,1629,1498,131,8
55079,2019,466908,448251,18657,4
55081,2019,23377,22672,705,3
55083,2019,20575,19830,745,3.6
55085,2019,17846,17071,775,4.3
55087,2019,103135,100059,3076,3
55089,2019,49030,47625,1405,2.9
55091,2019,4147,3991,156,3.8
55093,2019,25369,24504,865,3.4
55095,2019,24519,23519,1000,4.1
55097,2019,38592,37327,1265,3.3
55099,2019,6493,6207,286,4.4
55101,2019,98585,94556,4029,4.1
55103,2019,9219,8926,293,3.2
55105,2019,85330,82147,3183,3.7
55107,2019,6723,6393,330,4.9
55109,2019,50446,48754,1692,3.4
55111,2019,35576,34533,1043,2.9
55113,2019,7962,7582,380,4.8
55115,2019,21024,20342,682,3.2
55117,2019,62144,60436,1708,2.7
55119,2019,10973,10566,407,3.7
55121,2019,15952,15374,578,3.6
55123,2019,15278,14772,506,3.3
55125,2019,10154,9721,433,4.3
55127,2019,57872,55975,1897,3.3
55129,2019,7858,7536,322,4.1
55131,2019,77161,74950,2211,2.9
55133,2019,224731,218151,6580,2.9
55135,2019,25943,25093,850,3.3
55137,2019,11422,10955,467,4.1
55139,2019,91474,88728,2746,3
55141,2019,35136,33786,1350,3.8
56001,2019,20216,19595,621,3.1
56003,2019,5306,5083,223,4.2
56005,2019,23242,22389,853,3.7
56007,2019,7982,7720,262,3.3
56009,2019,8694,8456,238,2.7
56011,2019,3710,3593,117,3.2
56013,2019,18635,17811,824,4.4
56015,2019,6625,6387,238,3.6
56017,2019,2176,2099,77,3.5
56019,2019,4183,4032,151,3.6
56021,2019,48491,46813,1678,3.5
56023,2019,8876,8581,295,3.3
56025,2019,39348,37804,1544,3.9
56027,2019,1239,1205,34,2.7
56029,2019,15459,14839,620,4
56031,2019,4660,4501,159,3.4
56033,2019,15653,15111,542,3.5
56035,2019,4129,3947,182,4.4
56037,2019,21274,20446,828,3.9
56039,2019,15575,15151,424,2.7
56041,2019,9035,8682,353,3.9
56043,2019,3941,3786,155,3.9
56045,2019,3811,3701,110,2.9
72001,2019,4115,3485,630,15.3
72003,2019,11743,10553,1190,10.1
72005,2019,14350,12881,1469,10.2
72007,2019,6434,5846,588,9.1
72009,2019,6392,5722,670,10.5
72011,2019,8706,7967,739,8.5
72013,2019,23668,21413,2255,9.5
72015,2019,4605,3985,620,13.5
72017,2019,5827,5170,657,11.3
72019,2019,7261,6627,634,8.699999999999999
72021,2019,64124,60109,4015,6.3
72023,2019,13373,12214,1159,8.699999999999999
72025,2019,46941,43764,3177,6.8
72027,2019,9402,8597,805,8.6
72029,2019,15767,14727,1040,6.6
72031,2019,60399,56855,3544,5.9
72033,2019,7694,7140,554,7.2
72035,2019,15836,14727,1109,7
72037,2019,3658,3278,380,10.4
72039,2019,3651,3248,403,11
72041,2019,15237,14195,1042,6.8
72043,2019,9853,8647,1206,12.2
72045,2019,4817,4389,428,8.9
72047,2019,8806,8002,804,9.1
72049,2019,893,866,27,3
72051,2019,12937,12205,732,5.7
72053,2019,10804,9644,1160,10.7
72054,2019,3269,2914,355,10.9
72055,2019,3947,3364,583,14.8
72057,2019,10926,9605,1321,12.1
72059,2019,5002,4311,691,13.8
72061,2019,36917,35403,1514,4.1
72063,2019,17749,16741,1008,5.7
72065,2019,13427,11784,1643,12.2
72067,2019,5303,4847,456,8.6
72069,2019,16903,15193,1710,10.1
72071,2019,12214,11108,1106,9.1
72073,2019,4206,3614,592,14.1
72075,2019,14844,13361,1483,10
72077,2019,12067,11060,1007,8.300000000000001
72079,2019,5136,4480,656,12.8
72081,2019,6900,5883,1017,14.7
72083,2019,2617,2313,304,11.6
72085,2019,11103,10111,992,8.9
72087,2019,8275,7645,630,7.6
72089,2019,6093,5512,581,9.5
72091,2019,11319,10417,902,8
72093,2019,1895,1636,259,13.7
72095,2019,2902,2465,437,15.1
72097,2019,21542,19278,2264,10.5
72099,2019,10337,9257,1080,10.4
72101,2019,7843,7127,716,9.1
72103,2019,8007,7297,710,8.9
72105,2019,6953,6364,589,8.5
72107,2019,4883,4379,504,10.3
72109,2019,4276,3605,671,15.7
72111,2019,5830,5007,823,14.1
72113,2019,44991,40634,4357,9.699999999999999
72115,2019,5995,5297,698,11.6
72117,2019,4693,4047,646,13.8
72119,2019,16630,15414,1216,7.3
72121,2019,6064,5274,790,13
72123,2019,7062,6041,1021,14.5
72125,2019,9585,8509,1076,11.2
72127,2019,131645,124372,7273,5.5
72129,2019,11501,10490,1011,8.800000000000001
72131,2019,10198,8807,1391,13.6
72133,2019,8717,7764,953,10.9
72135,2019,26614,25106,1508,5.7
72137,2019,28675,27023,1652,5.8
72139,2019,26569,25281,1288,4.8
72141,2019,6588,5841,747,11.3
72143,2019,9554,8778,776,8.1
72145,2019,13037,11791,1246,9.6
72147,2019,2585,2406,179,6.9
72149,2019,7406,6231,1175,15.9
72151,2019,8691,7552,1139,13.1
72153,2019,9759,8331,1428,14.6
,,,,,
,,,,,
,,,,,
